4	ɾ
5	ɫ
9	œ
a	a
b	b
c	c
d	d
d:	dː
dZ	dʒ
e	e
f	f
g	ɡ
G	ɣ
i	i
j	j
J\	ɟ
k	k
l	l
l:	lː
m	m
M	ɯ
m:	mː
n	n
o	o
p	p
r	r
s	s
S	ʃ
s:	sː
t	t
t:	tː
tS	tʃ
u	u
v	v
x	x
y	y
z	z
Z	ʒ
{	æ
