Tsalkada	t s a 5 k a d a
aa	a
abičailar	a b i tS a i l a r
abičailari	a b i tS a i l a 4 i
abrazavaniemdır	a b 4 a z a v a n i e m d M r
abrazavanya	a b 4 a z a v a n j a
abıčai	a b M tS a i
abıčailari	a b M tS a i l a 4 i
adam	a d a m
adamdan	a d a m d a n
adamdır	a d a m d M r
adami	a d a m i
adamlar	a d a m l a r
adamlari	a d a m l a 4 i
adamıdi	a d a m M d i
adamım	a d a m M m
adamın	a d a m M n
adamıšlar	a d a m M S l a r
adi	a d i
adımi	a d M m i
adınd	a d M n d
adıni	a d M n i
aftada	a f t a d a
aftaya	a f t a j a
agoškasi	a g o S k a s i
agranomda	a g 4 a n o m d a
agranomdur	a g 4 a n o m d u r
agranomlıh	a g 4 a n o m l M x
ah	a x
ahan	a x a n
aher	a x e r
ahier	a x i e r
ahlıma	a x l M m a
ahlımagälmer	a x l M m a J\ { l m e r
ahlımda	a x l M m d a
ahnayah	a x n a j a x
ahılli	a x M 5 l i
ahšam	a x S a m
ahšama	a x S a m a
ahšamaačan	a x S a m a tS a n
ahšamačen	a x S a m a tS e n
ahšamdan	a x S a m d a n
ainanda	a i n a n d a
airandan	a i 4 a n d a n
airlandılar	a i 4 l a n d M 5 a r
airldılar	a i 4 l d M 5 a r
airos	a i 4 o s
aj	a dZ
ajabäz	a dZ a b { z
ajariadan	a dZ a 4 i a d a n
ajarlar	a dZ a 4 l a r
ajarlari	a dZ a 4 l a 4 i
ajarlarınan	a dZ a 4 l a 4 M n a n
ajda	a dZ d a
ajlarından	a dZ l a 4 M n d a n
ajlıh	a dZ l M x
ajlıhtan	a dZ l M x t a n
ajlıhıdi	a dZ l M x M d i
ajılıh	a dZ M 5 M x
ajına	a dZ M n a
ajından	a dZ M n d a n
akhalkalak	a x a 5 k a 5 a k
akhalkalakta	a x a 5 k a 5 a k t a
akoškasi	a k o S k a s i
ala	a 5 a
alajaih	a 5 a dZ a i x
alamadım	a 5 a m a d M m
aldi	a 5 d i
aldıh	a 5 d M x
aldılar	a 5 d M 5 a r
aldım	a 5 d M m
aler	a 5 e r
alerdıh	a 5 e 4 d M x
alerdılär	a 5 e 4 d M 5 { r
alerlär	a 5 e 4 l { r
alfavit	a 5 f a v i t
alfaviti	a 5 f a v i t i
alhıma	a 5 x M m a
alierdi	a 5 i e 4 d i
alir	a 5 i r
alirdılär	a 5 i 4 d M 5 { r
alirıh	a 5 i 4 M x
allah	a 5 l a x
allağa	a 5 l a G a
allağin	a 5 l a G i n
allağımızın	a 5 l a G M m M z M n
allağın	a 5 l a G M n
alma	a 5 m a
almaya	a 5 m a j a
almıšıh	a 5 m M S M x
alti	a 5 t i
altitänä	a 5 t i t { n {
altmıš	a 5 t m M S
altın	a 5 t M n
alırdılar	a 5 M 4 d M 5 a r
alıša	a 5 M S a
alıšabülir	a 5 M S a b y l i r
alıšamazıh	a 5 M S a m a z M x
alıšamierıh	a 5 M S a m i e 4 M x
alıšmah	a 5 M S m a x
alıštıh	a 5 M S t M x
alıšıra	a 5 M S M 4 a
am	a m
ama	a m a
amaša	a m a S a
ambelya	a m b e l j a
ambelä	a m b e l {
ambelädä	a m b e l { d {
ambelädır	a m b e l { d M r
ambu	a m b u
ambudur	a m b u d u r
amburada	a m b u 4 a d a
amburamda	a m b u 4 a m d a
amvelä	a m v e l {
an	a n
ana	a n a
anadan	a n a d a n
anai	a n a i
analari	a n a 5 a 4 i
analarım	a n a 5 a 4 M m
analarımız	a n a 5 a 4 M m M z
anam	a n a m
anama	a n a m a
anamda	a n a m d a
anamdan	a n a m d a n
anami	a n a m i
anamıdi	a n a m M d i
anamın	a n a m M n
anamınan	a n a m M n a n
anamızdan	a n a m M z d a n
anamızdır	a n a m M z d M r
anasi	a n a s i
anasiinän	a n a s i n { n
anbelä	a n b e l {
ane	a n e
anelä	a n e l {
angi	a n J\ i
angisiki	a n J\ i s i c i
angisıni	a n J\ i s M n i
angisıniki	a n J\ i s M n i c i
angisınnär	a n J\ i s M n n { r
angısi	a n g M s i
angısidır	a n g M s i d M r
angısiinanki	a n g M s i n a n c i
angısiki	a n g M s i c i
angısıni	a n g M s M n i
angısıniki	a n g M s M n i c i
angısının	a n g M s M n M n
anjah	a n dZ a x
anonnari	a n o n n a 4 i
ančelä	a n tS e l {
ar	a r
arabainan	a 4 a b a i n a n
arabalarınan	a 4 a b a 5 a 4 M n a n
arada	a 4 a d a
arasında	a 4 a s M n d a
arha	a 4 x a
arhein	a 4 x e i n
ari	a 4 i
arkadašlarımız	a 4 k a d a S l a 4 M m M z
armiadan	a 4 m i a d a n
armiaya	a 4 m i a j a
armiyaya	a 4 m i j a j a
armud	a 4 m u d
arpa	a 4 p a
artsivani	a 4 t s i v a n i
artsivaniidi	a 4 t s i v a n i d i
artıh	a 4 t M x
aryos	a 4 j o s
arımınän	a 4 M m M n { n
asnovnoi	a s n o v n o i
aspaplari	a s p a p l a 4 i
at	a t
ata	a t a
ataamanım	a t a m a n M m
ataanalar	a t a n a 5 a r
ataanamız	a t a n a m M z
atadan	a t a d a n
atadädä	a t a d { d {
atadädänın	a t a d { d { n M n
atierdi	a t i e 4 d i
atm	a t m
atsa	a t s a
avgustadır	a v g u s t a d M r
avgustta	a v g u s t: a
avgustun	a v g u s t u n
ay	a j
ayaği	a j a G i
azaldi	a z a 5 d i
azar	a z a r
azlıhtır	a z l M x t M r
azıdi	a z M d i
azırlanirıh	a z M 4 l a n i 4 M x
ačen	a tS e n
ačet	a tS e t
ačmıšl	a tS m M S l
ağa	a G a
ağlir	a G l i r
ağliram	a G l i 4 a m
ağırdılarda	a G M 4 d M 5 a 4 d a
ağırierdi	a G M 4 i e 4 d i
ağırir	a G M 4 i r
ašti	a S t i
ašğaladan	a S G a 5 a d a n
aššahta	a S S a x t a
baa	b a
baamın	b a m M n
baba	b a b a
babadan	b a b a d a n
babai	b a b a i
babalari	b a b a 5 a 4 i
babalarım	b a b a 5 a 4 M m
babalarımız	b a b a 5 a 4 M m M z
babalarımızda	b a b a 5 a 4 M m M z d a
babam	b a b a m
babama	b a b a m a
babamda	b a b a m d a
babamdan	b a b a m d a n
babami	b a b a m i
babamıdi	b a b a m M d i
babamın	b a b a m M n
babamınan	b a b a m M n a n
babamızdan	b a b a m M z d a n
babamızdır	b a b a m M z d M r
babanın	b a b a n M n
babasi	b a b a s i
babasida	b a b a s i d a
babasının	b a b a s M n M n
babuškama	b a b u S k a m a
babuškamda	b a b u S k a m d a
babuškamdır	b a b u S k a m d M r
babuškamın	b a b u S k a m M n
bah	b a x
bahalar	b a x a 5 a r
bahem	b a x e m
baherdılär	b a x e 4 d M 5 { r
baherdım	b a x e 4 d M m
baherlär	b a x e 4 l { r
bahien	b a x i e n
bahierdi	b a x i e 4 d i
bahierdıh	b a x i e 4 d M x
bahierlär	b a x i e 4 l { r
bahim	b a x i m
bahirdıh	b a x i 4 d M x
bahirlär	b a x i 4 l { r
bahmah	b a x m a x
bahti	b a x t i
bahtılar	b a x t M 5 a r
bahtım	b a x t M m
baiburta	b a i b u 4 t a
baiburtli	b a i b u 4 t l i
baiburtliam	b a i b u 4 t l i a m
baiburtta	b a i b u 4 t: a
bailedılär	b a i l e d M 5 { r
bairam	b a i 4 a m
bajaidi	b a dZ a i d i
bajalimajali	b a dZ a 5 i m a dZ a 5 i
baji	b a dZ i
bajılar	b a dZ M 5 a r
bajılarida	b a dZ M 5 a 4 i d a
bajılarımız	b a dZ M 5 a 4 M m M z
bajım	b a dZ M m
bajımıs	b a dZ M m M s
balkalari	b a 5 k a 5 a 4 i
balıh	b a 5 M x
balıhta	b a 5 M x t a
bar	b a r
barabar	b a 4 a b a r
barabarıdıh	b a 4 a b a 4 M d M x
basıp	b a s M p
batırierdım	b a t M 4 i e 4 d M m
bavlos	b a v l o s
bayahtan	b a j a x t a n
bayazovların	b a j a z o v l a 4 M n
bazar	b a z a r
bazarda	b a z a 4 d a
bazardır	b a z a 4 d M r
bazarlıh	b a z a 4 l M x
bazi	b a z i
baziki	b a z i c i
bazikida	b a z i c i d a
bazısi	b a z M s i
bašköv	b a S c 9 v
baškövdä	b a S c 9 v d {
baškövdür	b a S c 9 v d y r
baškövli	b a S c 9 v l i
baškövun	b a S c 9 v u n
baškövä	b a S c 9 v {
bašladi	b a S l a d i
bašladıh	b a S l a d M x
bašladılar	b a S l a d M 5 a r
bašlandi	b a S l a n d i
bašlarından	b a S l a 4 M n d a n
bašlerlär	b a S l e 4 l { r
bašliah	b a S l i a x
bašlirıh	b a S l i 4 M x
baštan	b a S t a n
baštanda	b a S t a n d a
be	b e
belay	b e l a j
bellirdıh	b e l: i 4 d M x
bellirıh	b e l: i 4 M x
belä	b e l {
belädır	b e l { d M r
beläidi	b e l { i d i
beš	b e S
beštä	b e S t {
beštänä	b e S t { n {
bibımdillär	b i b M m d i l: { r
bilämä	b i l { m {
bin	b i n
bindılar	b i n d M 5 a r
bir	b i r
birbirlärıni	b i 4 b i 4 l { 4 M n i
birbirlärınän	b i 4 b i 4 l { 4 M n { n
birbirımızi	b i 4 b i 4 M m M z i
birbirımızın	b i 4 b i 4 M m M z M n
birbirıni	b i 4 b i 4 M n i
birbirınä	b i 4 b i 4 M n {
birbizlärımızi	b i 4 b i z l { 4 M m M z i
birbırımızi	b i 4 b M 4 M m M z i
birbırımızınän	b i 4 b M 4 M m M z M n { n
birda	b i 4 d a
birdä	b i 4 d {
birdän	b i 4 d { n
birdır	b i 4 d M r
biri	b i 4 i
birida	b i 4 i d a
biridä	b i 4 i d {
biriinän	b i 4 i n { n
birkärän	b i 4 c { 4 { n
birtänä	b i 4 t { n {
birtänädä	b i 4 t { n { d {
biryanda	b i 4 j a n d a
birzamanda	b i 4 z a m a n d a
biräm	b i 4 { m
birär	b i 4 { r
biräz	b i 4 { z
biräzidä	b i 4 { z i d {
birğač	b i 4 G a tS
birın	b i 4 M n
birınji	b i 4 M n dZ i
birınjidır	b i 4 M n dZ i d M r
birınjikının	b i 4 M n dZ i k M n M n
birının	b i 4 M n M n
bitererıh	b i t e 4 e 4 M x
biz	b i z
bizdä	b i z d {
bizdän	b i z d { n
bizi	b i z i
bizlär	b i z l { r
bizläri	b i z l { 4 i
bizlärä	b i z l { 4 {
bizlärınän	b i z l { 4 M n { n
bizä	b i z {
bizıh	b i z M x
bizım	b i z M m
bizımda	b i z M m d a
bizımdä	b i z M m d {
bizımjılar	b i z M m dZ M 5 a r
bizımkimın	b i z M m c i m M n
bizımkılär	b i z M m k M 5 { r
bizımkındä	b i z M m k M n d {
bizımkınnär	b i z M m k M n n { r
bizımkınnärdän	b i z M m k M n n { 4 d { n
bizımkınärınän	b i z M m k M n { 4 M n { n
bizımnan	b i z M m n a n
bizımıdi	b i z M m M d i
bizınan	b i z M n a n
bizınän	b i z M n { n
bičir	b i tS i r
bičirlär	b i tS i 4 l { r
bičirıh	b i tS i 4 M x
biše	b i S e
bišedä	b i S e d {
bišelär	b i S e l { r
bišeläri	b i S e l { 4 i
bišem	b i S e m
bišerierdılär	b i S e 4 i e 4 d M 5 { r
bišesi	b i S e s i
bišesidä	b i S e s i d {
bišesıni	b i S e s M n i
bišeya	b i S e j a
bišırerlär	b i S M 4 e 4 l { r
bišırierdi	b i S M 4 i e 4 d i
bišırierlär	b i S M 4 i e 4 l { r
bišırirdi	b i S M 4 i 4 d i
bišırirıh	b i S M 4 i 4 M x
boinuna	b o i n u n a
bostanda	b o s t a n d a
boyadierdıh	b o j a d i e 4 d M x
boyadierlär	b o j a d i e 4 l { r
bozuldi	b o z u 5 d i
boš	b o S
bu	b u
buda	b u d a
budur	b u d u r
buhartan	b u x a 4 t a n
bujürä	b u dZ y 4 {
bukvasi	b u k v a s i
buldi	b u 5 d i
buldular	b u 5 d u 5 a r
buldum	b u 5 d u m
buligım	b u 5 i g M m
bulmah	b u 5 m a x
bulurlar	b u 5 u 4 l a r
buni	b u n i
bunnar	b u n n a r
bunnara	b u n n a 4 a
bunnardır	b u n n a 4 d M r
bunnari	b u n n a 4 i
bunnarınan	b u n n a 4 M n a n
bunun	b u n u n
bununda	b u n u n d a
bur	b u 4
bura	b u 4 a
buraa	b u 4 a
burada	b u 4 a d a
buradaidi	b u 4 a d a i d i
buradaidıh	b u 4 a d a i d M x
buralara	b u 4 a 5 a 4 a
buralarda	b u 4 a 5 a 4 d a
buranın	b u 4 a n M n
buraya	b u 4 a j a
burda	b u 4 d a
burdada	b u 4 d a d a
burdadır	b u 4 d a d M r
burdaidi	b u 4 d a i d i
burdaim	b u 4 d a i m
burdan	b u 4 d a n
burdanda	b u 4 d a n d a
burden	b u 4 d e n
burya	b u 4 j a
buyani	b u j a n i
bägändi	b { J\ { n d i
bägändılär	b { J\ { n d M 5 { r
bägändım	b { J\ { n d M m
bäjilda	b { dZ i l d a
bän	b { n
bändä	b { n d {
bändän	b { n d { n
bäni	b { n i
bänim	b { n i m
bännän	b { n n { n
bänziah	b { n z i a x
bänzämier	b { n z { m i e r
bänzämädım	b { n z { m { d M m
bänä	b { n {
bänıh	b { n M x
bänım	b { n M m
bänımdır	b { n M m d M r
bänımdırlär	b { n M m d M 4 l { r
bänımkınnär	b { n M m k M n n { r
bänın	b { n M n
bäräkät	b { 4 { c { t
bögün	b 9 J\ y n
bögünä	b 9 J\ y n {
bögünäačen	b 9 J\ y n { a tS e n
bögünähačet	b 9 J\ y n { x a tS e t
böldiisä	b 9 l d i s {
böyudyulär	b 9 j u d j u 5 { r
böyudüh	b 9 j u d y x
böyudüm	b 9 j u d y m
böyugi	b 9 j u J\ i
böyugümüz	b 9 j u J\ y m y z
böyuk	b 9 j u k
böyulduh	b 9 j u 5 d u x
böyuldämerdım	b 9 j u 5 d { m e 4 d M m
böyuldüm	b 9 j u 5 d y m
böyulttular	b 9 j u 5 t: u 5 a r
böyutti	b 9 j u t: i
böyüdüm	b 9 j y d y m
böyük	b 9 j y k
böyüklär	b 9 j y k l { r
böyüldi	b 9 j y l d i
böüldüm	b 9 y l d y m
büldühlärım	b y l d y x l { 4 M m
büldülär	b y l d y l { r
büler	b y l e r
bülerlär	b y l e 4 l { r
bülerıh	b y l e 4 M x
bülerım	b y l e 4 M m
bülieram	b y l i e 4 a m
bülierım	b y l i e 4 M m
bülir	b y l i r
bülirdi	b y l i 4 d i
bülirdıh	b y l i 4 d M x
bülirdılär	b y l i 4 d M 5 { r
bülirlär	b y l i 4 l { r
bülirıh	b y l i 4 M x
bülirım	b y l i 4 M m
bülmeram	b y l m e 4 a m
bülmerdi	b y l m e 4 d i
bülmerıh	b y l m e 4 M x
bülmerım	b y l m e 4 M m
bülmier	b y l m i e r
bülmierdılär	b y l m i e 4 d M 5 { r
bülmierdım	b y l m i e 4 d M m
bülmierım	b y l m i e 4 M m
bülmir	b y l m i r
bülmiram	b y l m i 4 a m
bülmirdıh	b y l m i 4 d M x
bülmirlär	b y l m i 4 l { r
bülmirıh	b y l m i 4 M x
bülmäh	b y l m { x
bülmäm	b y l m { m
bülä	b y l {
bülälär	b y l { l { r
bülünidır	b y l y n i d M r
bülünir	b y l y n i r
bülürdüh	b y l y 4 d y x
bılannari	b M 5 a n n a 4 i
bılašalar	b M 5 a S a 5 a r
choğ	x o G
chıhtım	x M x t M m
da	d a
daa	d a
dad	d a d
daha	d a x a
daima	d a i m a
daldalardan	d a 5 d a 5 a 4 d a n
damlirdi	d a m l i 4 d i
daralti	d a 4 a 5 t i
darar	d a 4 a r
darbazmarbaza	d a 4 b a z m a 4 b a z a
datli	d a t l i
davolniidıh	d a v o 5 n i d M x
davulzurna	d a v u 5 z u 4 n a
dağda	d a G d a
dağlar	d a G l a r
dağlarda	d a G l a 4 d a
dağıderlär	d a G M d e 4 l { r
dağıderıh	d a G M d e 4 M x
dağıdierlär	d a G M d i e 4 l { r
dağıdirdi	d a G M d i 4 d i
dağıldisä	d a G M 5 d i s {
dağıldıh	d a G M 5 d M x
daš	d a S
daši	d a S i
daštan	d a S t a n
de	d e
dedi	d e d i
deduškamdan	d e d u S k a m d a n
deduškami	d e d u S k a m i
deduškamın	d e d u S k a m M n
deduškamızın	d e d u S k a m M z M n
deduškanın	d e d u S k a n M n
dedälärım	d e d { l { 4 M m
dedılär	d e d M 5 { r
dedım	d e d M m
deilirdi	d e i l i 4 d i
dein	d e i n
delopraizvodstvada	d e l o p 4 a i z v o d s t v a d a
demäh	d e m { x
demäsiinän	d e m { s i n { n
desäm	d e s { m
di	d i
dia	d i a
diah	d i a x
dialekti	d i a 5 e k t i
dialektır	d i a 5 e k t M r
diamerım	d i a m e 4 M m
diamäzıh	d i a m { z M x
diardi	d i a 4 d i
diardılär	d i a 4 d M 5 { r
dibında	d i b M n d a
dibındä	d i b M n d {
diellär	d i e l: { r
diem	d i e m
dier	d i e r
dierdi	d i e 4 d i
dierdılär	d i e 4 d M 5 { r
dierlär	d i e 4 l { r
dierıh	d i e 4 M x
dierım	d i e 4 M m
diillär	d i l: { r
diir	d i r
diirdi	d i 4 d i
diirıh	d i 4 M x
dil	d i l
dilda	d i l d a
dildä	d i l d {
dildän	d i l d { n
dildändä	d i l d { n d {
dildır	d i l d M r
dili	d i l i
dilidä	d i l i d {
dilidır	d i l i d M r
dilinän	d i l i n { n
diljä	d i l dZ {
diljäi	d i l dZ { i
dillärıni	d i l: { 4 M n i
dilımız	d i l M m M z
dilımızi	d i l M m M z i
dilın	d i l M n
dilındä	d i l M n d {
dilındän	d i l M n d { n
dilıni	d i l M n i
dilınän	d i l M n { n
dilızi	d i l M z i
dinjälierdıh	d i n dZ { l i e 4 d M x
dinjälmähtä	d i n dZ { l m { x t {
dinjälmäya	d i n dZ { l m { j a
dinnärıni	d i n n { 4 M n i
dinızi	d i n M z i
dir	d i r
dizä	d i z {
dišärdä	d i S { 4 d {
dišäri	d i S { 4 i
dmanisidän	d m a n i s i d { n
dohkunji	d o x k u n dZ i
dohkuz	d o x k u z
dohkuzınji	d o x k u z M n dZ i
dohküzunjidan	d o x c y z u n dZ i d a n
doldi	d o 5 d i
doldurdum	d o 5 d u 4 d u m
doldurir	d o 5 d u 4 i r
dorği	d o 4 G i
družniih	d 4 u Z n i x
duiduh	d u i d u x
duimamıza	d u i m a m M z a
duimištim	d u i m i S t i m
duimušum	d u i m u S u m
duimıštıh	d u i m M S t M x
duimıšıh	d u i m M S M x
duirıh	d u i 4 M x
durduh	d u 4 d u x
durdular	d u 4 d u 5 a r
durdum	d u 4 d u m
durer	d u 4 e r
durierdi	d u 4 i e 4 d i
durierdıh	d u 4 i e 4 d M x
durierıh	d u 4 i e 4 M x
durir	d u 4 i r
durirıh	d u 4 i 4 M x
durirım	d u 4 i 4 M m
durlar	d u 4 l a r
durmirlär	d u 4 m i 4 l { r
dutar	d u t a r
dutarli	d u t a 4 l i
duterlär	d u t e 4 l { r
dutierdıh	d u t i e 4 d M x
dutierlär	d u t i e 4 l { r
dutirıh	d u t i 4 M x
dutmaya	d u t m a j a
dutmer	d u t m e r
dutmerdi	d u t m e 4 d i
dutmir	d u t m i r
duttular	d u t: u 5 a r
duvalamah	d u v a 5 a m a x
duvalirlär	d u v a 5 i 4 l { r
duvalirıh	d u v a 5 i 4 M x
duvar	d u v a r
dvorigınan	d v o 4 i g M n a n
dyadyam	d j a d j a m
dzalgada	d z a 5 g a d a
dä	d {
dädä	d { d {
dädädän	d { d { d { n
dädäläri	d { d { l { 4 i
dädälärim	d { d { l { 4 i m
dädälärım	d { d { l { 4 M m
dädäm	d { d { m
dädämdä	d { d { m d {
dädämi	d { d { m i
dädämın	d { d { m M n
dädämız	d { d { m M z
dädämızın	d { d { m M z M n
dädän	d { d { n
dädäsi	d { d { s i
dägildi	d { J\ i l d i
dägišl	d { J\ i S l
dägišmädıh	d { J\ i S m { d M x
dägišti	d { J\ i S t i
dägištıh	d { J\ i S t M x
dägišäjän	d { J\ i S { dZ { n
dägıl	d { g M 5
dägıldi	d { g M 5 d i
dägıllär	d { g M 5 l { r
dägıštırdılar	d { g M S t M 4 d M 5 a r
dägıšäjähsıs	d { g M S { dZ { x s M s
dängiz	d { n J\ i z
dängizä	d { n J\ i z {
därmän	d { 4 m { n
därmäni	d { 4 m { n i
däy	d { j
dögüš	d 9 J\ y S
dögüšdava	d 9 J\ y S d a v a
dögüšmerdıh	d 9 J\ y S m e 4 d M x
dögüšmäh	d 9 J\ y S m { x
dögüštän	d 9 J\ y S t { n
dögüšün	d 9 J\ y S y n
döndi	d 9 n d i
dönmäh	d 9 n m { x
dördunäda	d 9 4 d u n { d a
dördünji	d 9 4 d y n dZ i
dört	d 9 4 t
dörtjannan	d 9 4 t dZ a n n a n
dörttänä	d 9 4 t: { n {
dörttänädır	d 9 4 t: { n { d M r
dörttänäih	d 9 4 t: { n { i x
dörttänäm	d 9 4 t: { n { m
dörtyanıni	d 9 4 t j a n M n i
dörtänä	d 9 4 t { n {
dövlätımız	d 9 v l { t M m M z
döšürirdılär	d 9 S y 4 i 4 d M 5 { r
dügün	d y J\ y n
dügünnäri	d y J\ y n n { 4 i
dügünnärınän	d y J\ y n n { 4 M n { n
dümdüzdür	d y m d y z d y r
dünäya	d y n { j a
düsti	d y s t i
düz	d y z
düzlänmer	d y z l { n m e r
düzlänändır	d y z l { n { n d M r
düzäldi	d y z { l d i
düzäldılär	d y z { l d M 5 { r
düzälti	d y z { l t i
düzälttılar	d y z { l t: M 5 a r
düzälä	d y z { l {
düzüni	d y z y n i
düšmäsın	d y S m { s M n
düšti	d y S t i
düštüh	d y S t y x
düštülär	d y S t y l { r
düšär	d y S { r
düšündi	d y S y n d i
düšündülär	d y S y n d y l { r
düšünerdılär	d y S y n e 4 d M 5 { r
düšünerlär	d y S y n e 4 l { r
düšünirdi	d y S y n i 4 d i
düšünirım	d y S y n i 4 M m
dır	d M r
džinis	d Z i n i s
eddi	e d: i
eddijanıh	e d: i dZ a n M x
eddikilissä	e d: i c i l i s: {
eddikilisä	e d: i c i l i s {
eddikilisädä	e d: i c i l i s { d {
eddikilisädän	e d: i c i l i s { d { n
eddikilisäya	e d: i c i l i s { j a
eddikissädä	e d: i c i s: { d {
eddikissädän	e d: i c i s: { d { n
eddikissädır	e d: i c i s: { d M r
edditänä	e d: i t { n {
edditänäidıh	e d: i t { n { i d M x
eddısi	e d: M s i
edem	e d e m
eder	e d e r
ederdıh	e d e 4 d M x
ederdılär	e d e 4 d M 5 { r
ederlär	e d e 4 l { r
ederıh	e d e 4 M x
ederım	e d e 4 M m
edi	e d i
edier	e d i e r
edierdi	e d i e 4 d i
edierdılär	e d i e 4 d M 5 { r
edierdım	e d i e 4 d M m
edierlär	e d i e 4 l { r
edierıh	e d i e 4 M x
edir	e d i r
edirdi	e d i 4 d i
edirdıh	e d i 4 d M x
edirdılär	e d i 4 d M 5 { r
edirlär	e d i 4 l { r
edirıh	e d i 4 M x
edirım	e d i 4 M m
edäbüldi	e d { b y l d i
edäh	e d { x
edälär	e d { l { r
edämerıh	e d { m e 4 M x
edämierlär	e d { m i e 4 l { r
edämäm	e d { m { m
edänäčen	e d { n { tS e n
edärdi	e d { 4 d i
edärdıh	e d { 4 d M x
edärih	e d { 4 i x
edırırdılar	e d M 4 M 4 d M 5 a r
ee	e e
eem	e e m
egi	e J\ i
egıl	e g M 5
egıler	e g M 5 e r
egılärıni	e g M 5 { 4 M n i
ehıldi	e x M 5 d i
ehšli	e x S l i
ei	e i
eidır	e i d M r
ein	e i n
ekkä	e k c {
el	e l
ela	e l a
elda	e l d a
eldan	e l d a n
eli	e l i
ellar	e l: a r
ellarda	e l: a 4 d a
ellarımız	e l: a 4 M m M z
elya	e l j a
elä	e l {
elädä	e l { d {
elädır	e l { d M r
eläidi	e l { i d i
elälığınän	e l { l M G M n { n
eläsi	e l { s i
elın	e l M n
elınan	e l M n a n
emahlari	e m a x l a 4 i
emäh	e m { x
emäkläri	e m { k l { 4 i
emäya	e m { j a
engi	e n J\ i
enišä	e n i S {
epei	e p e i
epeim	e p e i m
er	e r
erdä	e 4 d {
erdädä	e 4 d { d {
erdädır	e 4 d { d M r
erdän	e 4 d { n
eri	e 4 i
erlär	e 4 l { r
erlärdän	e 4 l { 4 d { n
erläri	e 4 l { 4 i
erlärıdi	e 4 l { 4 M d i
erlärındän	e 4 l { 4 M n d { n
erläštılär	e 4 l { S t M 5 { r
erläšänahače	e 4 l { S { n a x a tS e
ermanılär	e 4 m a n M 5 { r
ermanılärınän	e 4 m a n M 5 { 4 M n { n
ermänılär	e 4 m { n M 5 { r
erä	e 4 {
erıdi	e 4 M d i
erımız	e 4 M m M z
erınä	e 4 M n {
erıšti	e 4 M S t i
etmierdıh	e t m i e 4 d M x
etmierdım	e t m i e 4 d M m
etmierıh	e t m i e 4 M x
etmir	e t m i r
etmirlär	e t m i 4 l { r
etmäh	e t m { x
etmäya	e t m { j a
etmıšti	e t m M S t i
etmıštıh	e t m M S t M x
etsın	e t s M n
etti	e t: i
ettıh	e t: M x
ettılar	e t: M 5 a r
ettılär	e t: M 5 { r
ettım	e t: M m
etım	e t M m
evlädän	e v l { d { n
evrapeiski	e v 4 a p e i s c i
ey	e j
eydir	e j d i r
eydır	e j d M r
eydırlär	e j d M 4 l { r
eyidi	e j i d i
eykä	e j c {
eysın	e j s M n
eyıdi	e j M d i
eč	e tS
ečbiše	e tS b i S e
eğılanda	e G M 5 a n d a
eğılerıh	e G M 5 e 4 M x
eğılier	e G M 5 i e r
eğılierıh	e G M 5 i e 4 M x
eğılir	e G M 5 i r
eğılirdılär	e G M 5 i 4 d M 5 { r
eğılirlär	e G M 5 i 4 l { r
eğılirıh	e G M 5 i 4 M x
ešigın	e S i g M n
ešlärım	e S l { 4 M m
fahır	f a x M r
fahırlıh	f a x M 4 l M x
fahırlıhta	f a x M 4 l M x t a
fahırlığ	f a x M 4 l M G
fahırlığıdi	f a x M 4 l M G M d i
fahırıdıh	f a x M 4 M d M x
fahırıdılar	f a x M 4 M d M 5 a r
familya	f a m i l j a
familyadan	f a m i l j a d a n
familyadır	f a m i l j a d M r
fevralda	f e v 4 a 5 d a
fotič	f o t i tS
fp_a	a
fp_aa	a
fp_aha	a x a
fp_aj	a dZ
fp_am	a m
fp_an	a n
fp_da	d a
fp_e	e
fp_ee	e e
fp_em	e m
fp_ha	x a
fp_hä	x {
fp_i	i
fp_m	m
fp_m!	m
fp_mm	m
fp_nu_vot	n u v o t
fp_näblem	n { b l e m
fp_okey	o k e i
fp_sora	s o 4 a
fp_uf	u f
fp_ugu	u g u
fp_vot	v o t
fp_ya	j a
fp_äm	{ m
fp_šee	S e
fs	f s
fs_a	a
fs_aj	a dZ
fs_ama	a m a
fs_an	a n
fs_anamız	a n a m M z
fs_aniki	a n i c i
fs_ar	a r
fs_arg	a r g
fs_ay	a j
fs_azar	a z a r
fs_b	b
fs_ba	b a
fs_babam	b a b a m
fs_be	b e
fs_bi	b i
fs_bir	b i r
fs_biräm	b i 4 { m
fs_biz	b i z
fs_bizä	b i z {
fs_bizım	b i z M m
fs_burda	b u 4 d a
fs_bän	b { n
fs_böyü	b 9 j y
fs_davuzurna	d a v u z u 4 n a
fs_de	d e
fs_dil	d i l
fs_dilı	d i l M
fs_dište	d i S t e
fs_dmanisis	d m a n i s i s
fs_do	d o
fs_druzni	d 4 u z n i
fs_durii	d u 4 i
fs_dvatsat	d v a t s a t
fs_dögüštän	d 9 J\ y S t { n
fs_e	e
fs_ed	e d
fs_edditälä	e d: i t { l {
fs_edi	e d i
fs_edäh	e d { x
fs_elä	e l {
fs_elädır	e l { d M r
fs_epeim	e p e i m
fs_erläšälär	e 4 l { S { l { r
fs_eč	e tS
fs_eše	e S e
fs_f	f
fs_g	g
fs_gi	J\ i
fs_gru	g 4 u
fs_gyo	g j o
fs_gä	J\ {
fs_gäl	J\ { l
fs_gü	J\ y
fs_gürjis	J\ y 4 dZ i s
fs_h	x
fs_ha	x a
fs_hal	x a 5
fs_halh	x a 5 x
fs_ho	x o
fs_i	i
fs_igirmi	i J\ i 4 m i
fs_iz	i z
fs_ištem	i S t e m
fs_ji	dZ i
fs_k	k
fs_ka	k a
fs_kask	k a s k
fs_kh	x
fs_khristians>	x 4 i s t i a n s
fs_khristosdır	x 4 i s t o s d M r
fs_ki	c i
fs_kim	c i m
fs_kis	c i s
fs_käs	c { s
fs_kö	c 9
fs_köti	c 9 t i
fs_köv	c 9 v
fs_kövdä	c 9 v d a
fs_kövlärdän	c 9 v l { 4 d { n
fs_kür	c y r
fs_la	l a
fs_m	m
fs_mamam	m a m a m
fs_me	m e
fs_muzıkada	m u z M k a d a
fs_mı	m M
fs_na	n a
fs_ne	n e
fs_ni	n i
fs_nä	n {
fs_näsıl	n { s M 5
fs_o	o
fs_ol	o 5
fs_olir	o 5 i r
fs_on	o n
fs_onnar	o n n a r
fs_ora	o 4 a
fs_orda	o 4 d a
fs_ottuz	o t: u z
fs_ovahıt	o v a x M t
fs_pakla	p a k l a
fs_paska	p a s k a
fs_per	p e 4
fs_po	p o
fs_pra	p 4 a
fs_ra	4 a
fs_ruski	4 u s c i
fs_russki	4 u s c i
fs_s	s
fs_savkho	s a v x o
fs_savkhozda	s a v x o z d a
fs_selskhoz	s e l s k o z
fs_sora	s o 4 a
fs_sva	s v a
fs_t	t
fs_tiflis	t i f l i s
fs_tsal	t s a 5
fs_turtsiada	t u 4 t s i a d a
fs_u	u
fs_utr	u t 4
fs_var	v a r
fs_vete	v e t e
fs_väd	v { d
fs_ya	j a
fs_yašam	j a S a m
fs_yaše	j a S e
fs_yaširdıh	j a S i 4 d M x
fs_ä	{
fs_är	{ r
fs_ävl	{ v l
fs_ö	9
fs_öläng	9 l { n g
fs_ü	y
fs_č	tS
fs_čağer	tS a G e r
fs_čete	tS e t e
fs_čoräk	tS o 4 a k
fs_čoğ	tS o G
fs_ğ	G
fs_ğala	G a 5 a
fs_ğurbanığ	G u 4 b a n M G
fs_ğız	G M z
fs_š	S
fs_še	S e
fs_šei	S e i
fs_šindi	S i n d i
fs_školada	S k o 5 a d a
fs_št	S t
fuharaa	f u x a 4 a
fyodor	f j o d o r
fıharaidi	f M x a 4 a i d i
fırladirlär	f M 4 l a d i 4 l { r
fırladirıh	f M 4 l a d i 4 M x
fırlanirıh	f M 4 l a n i 4 M x
fırın	f M 4 M n
fırınlar	f M 4 M n l a r
fırınımız	f M 4 M n M m M z
gapısının	g a p M s M n M n
gardašlarım	g a 4 d a S l a 4 M m
gardeli	g a 4 d e l i
gasudarstvoidi	g a s u d a 4 s t v o i d i
gavigürügeinän	g a v i J\ y 4 y J\ e i n { n
gavlarınan	g a v l a 4 M n a n
gavınan	g a v M n a n
gaz	g a z
geagrafiaida	J\ e a g 4 a f i a i d a
gedın	J\ e d M n
geinnänmıš	J\ e i n n { n m M S
gej	J\ e dZ
gejä	J\ e dZ {
gejädä	J\ e dZ { d {
gejädän	J\ e dZ { d { n
gelda	J\ e l d a
gena	J\ e n a
generali	J\ e n e 4 a 5 i
genä	J\ e n {
genädä	J\ e n { d {
geri	J\ e 4 i
geridäki	J\ e 4 i d { c i
geriki	J\ e 4 i c i
germanialara	J\ e 4 m a n i a 5 a 4 a
gerıdä	J\ e 4 M d {
gerısıni	J\ e 4 M s M n i
gerısınidä	J\ e 4 M s M n i d {
getmer	J\ e t m e r
getmierdım	J\ e t m i e 4 d M m
getmierım	J\ e t m i e 4 M m
getmirlär	J\ e t m i 4 l { r
getmirım	J\ e t m i 4 M m
getmädıh	J\ e t m { d M x
getmädım	J\ e t m { d M m
getmäh	J\ e t m { x
getmäm	J\ e t m { m
getmıšti	J\ e t m M S t i
getmıšıh	J\ e t m M S M x
getti	J\ e t: i
gettiärä	J\ e t: i { 4 {
gettıh	J\ e t: M x
gettıhča	J\ e t: M x tS a
gettılar	J\ e t: M 5 a r
gettılär	J\ e t: M 5 { r
gettım	J\ e t: M m
gečah	J\ e tS a x
gečerdi	J\ e tS e 4 d i
gečererdıh	J\ e tS e 4 e 4 d M x
gečir	J\ e tS i r
gečirdi	J\ e tS i 4 d i
gečmer	J\ e tS m e r
gečti	J\ e tS t i
gečtıh	J\ e tS t M x
gečtılär	J\ e tS t M 5 { r
gečtım	J\ e tS t M m
gečännäridä	J\ e tS { n n { 4 i d {
gečürierlär	J\ e tS y 4 i e 4 l { r
gečırerıh	J\ e tS M 4 e 4 M x
gečırierıh	J\ e tS M 4 i e 4 M x
gečırirıh	J\ e tS M 4 i 4 M x
gešti	J\ e S t i
geštıh	J\ e S t M x
geštılar	J\ e S t M 5 a r
giden	J\ i d e n
giderdım	J\ i d e 4 d M m
giderlär	J\ i d e 4 l { r
giderıh	J\ i d e 4 M x
giderım	J\ i d e 4 M m
gidien	J\ i d i e n
gidier	J\ i d i e r
gidieram	J\ i d i e 4 a m
gidierdi	J\ i d i e 4 d i
gidierdıh	J\ i d i e 4 d M x
gidierdılär	J\ i d i e 4 d M 5 { r
gidierdım	J\ i d i e 4 d M m
gidierlär	J\ i d i e 4 l { r
gidierıh	J\ i d i e 4 M x
gidierım	J\ i d i e 4 M m
gidim	J\ i d i m
gidip	J\ i d i p
gidir	J\ i d i r
gidirdıh	J\ i d i 4 d M x
gidirdılär	J\ i d i 4 d M 5 { r
gidirdım	J\ i d i 4 d M m
gidirdın	J\ i d i 4 d M n
gidirlär	J\ i d i 4 l { r
gidirıh	J\ i d i 4 M x
gidirım	J\ i d i 4 M m
gidä	J\ i d {
gidäh	J\ i d { x
gidäjäh	J\ i d { dZ { x
gidäjäm	J\ i d { dZ { m
gidäjän	J\ i d { dZ { n
gidämierdım	J\ i d { m i e 4 d M m
gidämierım	J\ i d { m i e 4 M m
gidämädıh	J\ i d { m { d M x
gidändän	J\ i d { n d { n
gidärdım	J\ i d { 4 d M m
gidärih	J\ i d { 4 i x
gidärlär	J\ i d { 4 l { r
gidıp	J\ i d M p
gipsınän	J\ i p s M n { n
girdi	J\ i 4 d i
girdıh	J\ i 4 d M x
girdılär	J\ i 4 d M 5 { r
girdım	J\ i 4 d M m
girierdi	J\ i 4 i e 4 d i
girirlär	J\ i 4 i 4 l { r
girirıh	J\ i 4 i 4 M x
girmäh	J\ i 4 m { x
girä	J\ i 4 {
giräjäih	J\ i 4 { dZ { i x
godda	g o d: a
goddaidi	g o d: a i d i
goddan	g o d: a n
goddır	g o d: M r
gramotni	g 4 a m o t n i
gramotnıda	g 4 a m o t n M d a
greklär	g 4 e k l { r
gretsia	g 4 e t s i a
gretsiad	g 4 e t s i a
gretsiada	g 4 e t s i a d a
gretsiadadırlar	g 4 e t s i a d a d M 4 l a r
gretsiadaidi	g 4 e t s i a d a i d i
gretsiadan	g 4 e t s i a d a n
gretsiainan	g 4 e t s i a i n a n
gretsialara	g 4 e t s i a 5 a 4 a
gretsianın	g 4 e t s i a n M n
gretsiaya	g 4 e t s i a j a
greče	g 4 e tS e
grečeski	g 4 e tS e s c i
grečeskii	g 4 e tS e s c i
gruziada	g 4 u z i a d a
gruziadada	g 4 u z i a d a d a
gruziadanda	g 4 u z i a d a n d a
gruzianın	g 4 u z i a n M n
gruziaya	g 4 u z i a j a
gruzinski	g 4 u z i n s c i
gruzinskii	g 4 u z i n s c i
gurnašit	g u 4 n a S i t
gurtuldum	g u 4 t u 5 d u m
guzäl	g u z { l
gä	J\ {
gäldi	J\ { l d i
gäldilär	J\ { l d i l { r
gäldlär	J\ { l d l { r
gäldıh	J\ { l d M x
gäldıhtan	J\ { l d M x t a n
gäldılar	J\ { l d M 5 a r
gäldılär	J\ { l d M 5 { r
gäldım	J\ { l d M m
gäler	J\ { l e r
gälerdi	J\ { l e 4 d i
gälerdılär	J\ { l e 4 d M 5 { r
gälerlär	J\ { l e 4 l { r
gälerıh	J\ { l e 4 M x
gälier	J\ { l i e r
gälierdi	J\ { l i e 4 d i
gälierdıh	J\ { l i e 4 d M x
gälierdılär	J\ { l i e 4 d M 5 { r
gälierlär	J\ { l i e 4 l { r
gälierıh	J\ { l i e 4 M x
gälir	J\ { l i r
gälirdi	J\ { l i 4 d i
gälirdıh	J\ { l i 4 d M x
gälirdılär	J\ { l i 4 d M 5 { r
gälirlär	J\ { l i 4 l { r
gälirıh	J\ { l i 4 M x
gälmerlär	J\ { l m e 4 l { r
gälmier	J\ { l m i e r
gälmierlär	J\ { l m i e 4 l { r
gälmirdılär	J\ { l m i 4 d M 5 { r
gälmirlär	J\ { l m i 4 l { r
gälmiš	J\ { l m i S
gälmišlär	J\ { l m i S l { r
gälmišıh	J\ { l m i S M x
gälmädi	J\ { l m { d i
gälmäh	J\ { l m { x
gälmämištılar	J\ { l m { m i S t M 5 a r
gälmäya	J\ { l m { j a
gälmıš	J\ { l m M S
gälmıšti	J\ { l m M S t i
gälmıštılar	J\ { l m M S t M 5 a r
gälmıšıh	J\ { l m M S M x
gälsälär	J\ { l s { l { r
gälsın	J\ { l s M n
gälä	J\ { l {
gäläidılär	J\ { l { i d M 5 { r
gäläjah	J\ { l { dZ a x
gälälär	J\ { l { l { r
gälämerım	J\ { l { m e 4 M m
gälän	J\ { l { n
gäländän	J\ { l { n d { n
gälännärdä	J\ { l { n n { 4 d {
gälänsıra	J\ { l { n s M 4 a
gälänähačet	J\ { l { n { x a tS e t
gälänäčet	J\ { l { n { tS e t
gälıpčıhmadi	J\ { l M p tS M x m a d i
gälırdi	J\ { l M 4 d i
gälırsın	J\ { l M 4 s M n
gändi	J\ { n d i
gändılär	J\ { n d M 5 { r
gändılära	J\ { n d M 5 { 4 a
gändılärın	J\ { n d M 5 { 4 M n
gändım	J\ { n d M m
gändımın	J\ { n d M m M n
gändımız	J\ { n d M m M z
gändınä	J\ { n d M n {
gändının	J\ { n d M n M n
gäräk	J\ { 4 { k
gäräkliidi	J\ { 4 { k l i d i
gäräktädır	J\ { 4 { k t { d M r
gätırdi	J\ { t M 4 d i
gätırdıh	J\ { t M 4 d M x
gätırdılär	J\ { t M 4 d M 5 { r
gätırerlär	J\ { t M 4 e 4 l { r
gätırierlär	J\ { t M 4 i e 4 l { r
gätırirdıh	J\ { t M 4 i 4 d M x
gätırirlär	J\ { t M 4 i 4 l { r
gätırirıh	J\ { t M 4 i 4 M x
gätırmiš	J\ { t M 4 m i S
gätırsın	J\ { t M 4 s M n
gätırälär	J\ { t M 4 { l { r
gäzierdılär	J\ { z i e 4 d M 5 { r
gäzierlär	J\ { z i e 4 l { r
gäzirdılär	J\ { z i 4 d M 5 { r
gäzirıh	J\ { z i 4 M x
gäzär	J\ { z { r
gäčırerıh	J\ { tS M 4 e 4 M x
göl	J\ 9 l
göldur	J\ 9 l d u r
gölün	J\ 9 l y n
gömdülär	J\ 9 m d y l { r
gömärsıs	J\ 9 m { 4 s M s
gömülidır	J\ 9 m y l i d M r
gördi	J\ 9 4 d i
gördüh	J\ 9 4 d y x
gördülär	J\ 9 4 d y l { r
gördüm	J\ 9 4 d y m
görerdılär	J\ 9 4 e 4 d M 5 { r
görieram	J\ 9 4 i e 4 a m
görirsä	J\ 9 4 i 4 s {
görmerım	J\ 9 4 m e 4 M m
görmišıh	J\ 9 4 m i S M x
görmišım	J\ 9 4 m i S M m
görmämišım	J\ 9 4 m { m i S M m
görsädierdılär	J\ 9 4 s { d i e 4 d M 5 { r
görsädir	J\ 9 4 s { d i r
görsättılar	J\ 9 4 s { t: M 5 a r
görä	J\ 9 4 {
görämien	J\ 9 4 { m i e n
görünier	J\ 9 4 y n i e r
götürdülär	J\ 9 t y 4 d y l { r
götürer	J\ 9 t y 4 e r
götürerlär	J\ 9 t y 4 e 4 l { r
götürierlär	J\ 9 t y 4 i e 4 l { r
götürir	J\ 9 t y 4 i r
götürirıh	J\ 9 t y 4 i 4 M x
götürär	J\ 9 t y 4 { r
götürür	J\ 9 t y 4 y r
gözi	J\ 9 z i
gözlierlär	J\ 9 z l i e 4 l { r
gözlärımızä	J\ 9 z l { 4 M m M z {
güjistanda	J\ y dZ i s t a n d a
gülerlär	J\ y l e 4 l { r
gülir	J\ y l i r
gün	J\ y n
gündür	J\ y n d y r
gündır	J\ y n d M r
güni	J\ y n i
günnär	J\ y n n { r
günnäri	J\ y n n { 4 i
günnäridä	J\ y n n { 4 i d {
günnärımızi	J\ y n n { 4 M m M z i
günüdi	J\ y n y d i
günümüzi	J\ y n y m y z i
günündä	J\ y n y n d {
gününä	J\ y n y n {
günüsi	J\ y n y s i
gürji	J\ y 4 dZ i
gürjia	J\ y 4 dZ i a
gürjidırlär	J\ y 4 dZ i d M 4 l { r
gürjii	J\ y 4 dZ i
gürjilär	J\ y 4 dZ i l { r
gürjimürji	J\ y 4 dZ i m y 4 dZ i
gürjistana	J\ y 4 dZ i s t a n a
gürjistanda	J\ y 4 dZ i s t a n d a
gürjistandadır	J\ y 4 dZ i s t a n d a d M r
gürjistandaidıh	J\ y 4 dZ i s t a n d a i d M x
gürjistandan	J\ y 4 dZ i s t a n d a n
gürjüjä	J\ y 4 dZ y dZ {
gürjüjädä	J\ y 4 dZ y dZ { d {
gürjüjäi	J\ y 4 dZ y dZ { i
gürjülär	J\ y 4 dZ y l { r
gürjülärdä	J\ y 4 dZ y l { 4 d {
gürjülärın	J\ y 4 dZ y l { 4 M n
gürjülärınan	J\ y 4 dZ y l { 4 M n a n
gürjülärınän	J\ y 4 dZ y l { 4 M n { n
gürjüstana	J\ y 4 dZ y s t a n a
gürjüstanda	J\ y 4 dZ y s t a n d a
gürjüstänä	J\ y 4 dZ y s t { n {
güverlär	J\ y v e 4 l { r
güvierdıh	J\ y v i e 4 d M x
güzal	J\ y z a 5
güzäl	J\ y z { l
güzäldä	J\ y z { l d {
güzälıdi	J\ y z { l M d i
gırh	g M 4 x
gıčlarımda	g M tS l a 4 M m d a
ha	x a
halh	x a 5 x
halha	x a 5 x a
halhada	x a 5 x a d a
halhi	x a 5 x i
halhiih	x a 5 x i x
halhta	x a 5 x t a
halhıdi	x a 5 x M d i
halhımız	x a 5 x M m M z
halhımızınan	x a 5 x M m M z M n a n
halhın	x a 5 x M n
halhınan	x a 5 x M n a n
halılari	x a 5 M 5 a 4 i
hama	x a m a
haralambos	x a 4 a 5 a m b o s
haralambosa	x a 4 a 5 a m b o s a
haralammbos	x a 4 a 5 a m: b o s
haspahčadan	x a s p a x tS a d a n
hazyaistvenni	x a z j a i s t v e n n i
hazyaistvennimazaistvenni	x a z j a i s t v e n n i m a z a i s t v e n n i
hašlir	x a S l i r
heč	x e tS
ho	x o
hošgälerdi	x o S J\ { l e 4 d i
hošuma	x o S u m a
hrami	x 4 a m i
hristiannar	x 4 i s t i a n n a r
hristianıh	x 4 i s t i a n M x
hä	x {
häm	x { m
hämdä	x { m d {
häp	x { p
här	x { r
härızä	x { 4 M z {
hästä	x { s t {
hästäda	x { s t { d a
hısım	x M s M m
hısımi	x M s M m i
hısımmısımlarımız	x M s M m m M s M m l a 4 M m M z
iamana	i a m a n a
ichında	i x M n d a
ichındä	i x M n d {
idi	i d i
ier	i e r
ierlär	i e 4 l { r
iet	i e t
igirmi	i J\ i 4 m i
iip	i p
iir	i r
iirdılär	i 4 d M 5 { r
iirlär	i 4 l { r
iirıh	i 4 M x
iki	i c i
ikiaačan	i c i a tS a n
ikidä	i c i d {
ikikärän	i c i c { 4 { n
ikimızıh	i c i m M z M x
ikisidä	i c i s i d {
ikitänä	i c i t { n {
ikımızdä	i k M m M z d {
ikınji	i k M n dZ i
ikınjı	i k M n dZ M
ikısi	i k M s i
ikısidä	i k M s i d {
ilärlir	i l { 4 l i r
inamımız	i n a m M m M z
inanirıh	i n a n i 4 M x
inanmien	i n a n m i e n
inanmirlär	i n a n m i 4 l { r
instituta	i n s t i t u t a
instituti	i n s t i t u t i
institutta	i n s t i t u t: a
integratsiaya	i n t e g 4 a t s i a j a
interesınä	i n t e 4 e s M n {
inägi	i n { J\ i
inäk	i n { k
inäkläri	i n { k l { 4 i
inäkminägınän	i n { k m i n { g M n { n
inäktän	i n { k t { n
iräldän	i 4 { l d { n
iräldändä	i 4 { l d { n d {
iräli	i 4 { l i
irällädıh	i 4 { l: { d M x
irällädılär	i 4 { l: { d M 5 { r
isa	i s a
islanmıš	i s l a n m M S
ismida	i s m i d a
isterlär	i s t e 4 l { r
isterıh	i s t e 4 M x
isterım	i s t e 4 M m
istian	i s t i a n
istierdi	i s t i e 4 d i
istiersıs	i s t i e 4 s M s
istir	i s t i r
istirdi	i s t i 4 d i
istirıh	i s t i 4 M x
istirım	i s t i 4 M m
istoriamız	i s t o 4 i a m M z
istoriasi	i s t o 4 i a s i
istädi	i s t { d i
istädıh	i s t { d M x
istämerlär	i s t { m e 4 l { r
istämädılär	i s t { m { d M 5 { r
itırdılär	i t M 4 d M 5 { r
itırerıh	i t M 4 e 4 M x
itırirsız	i t M 4 i 4 s M z
itırmadılar	i t M 4 m a d M 5 a r
itırmädıh	i t M 4 m { d M x
itırälär	i t M 4 { l { r
izın	i z M n
iän	i { n
ičerlär	i tS e 4 l { r
ičierlär	i tS i e 4 l { r
ičir	i tS i r
ičirdıh	i tS i 4 d M x
ičirlär	i tS i 4 l { r
ičirıh	i tS i 4 M x
ički	i tS c i
ičlärındä	i tS l { 4 M n d {
ičmäh	i tS m { x
ičmähtır	i tS m { x t M r
ičmäya	i tS m { j a
ičärdä	i tS { 4 d {
ičäri	i tS { 4 i
ičın	i tS M n
ičında	i tS M n d a
ičındä	i tS M n d {
ičındädä	i tS M n d { d {
ičınä	i tS M n {
ičırierdi	i tS M 4 i e 4 d i
iš	i S
iši	i S i
išini	i S i n i
išlerdıh	i S l e 4 d M x
išliajän	i S l i a dZ { n
išlialar	i S l i a 5 a r
išlialär	i S l i a 5 { r
išlian	i S l i a n
išlierdi	i S l i e 4 d i
išlierdılär	i S l i e 4 d M 5 { r
išlierdım	i S l i e 4 d M m
išlierlär	i S l i e 4 l { r
išlierıh	i S l i e 4 M x
išliip	i S l i p
išlip	i S l i p
išlir	i S l i r
išlirdi	i S l i 4 d i
išlirdıh	i S l i 4 d M x
išlirdılär	i S l i 4 d M 5 { r
išlirdım	i S l i 4 d M m
išlirlär	i S l i 4 l { r
išlirıh	i S l i 4 M x
išlirım	i S l i 4 M m
išliya	i S l i j a
išlädirıh	i S l { d i 4 M x
išlädıh	i S l { d M x
išlädılar	i S l { d M 5 a r
išlädılär	i S l { d M 5 { r
išlädım	i S l { d M m
išlämirıh	i S l { m i 4 M x
išlämäh	i S l { m { x
išlämäya	i S l { m { j a
išlär	i S l { r
išläri	i S l { 4 i
išlärä	i S l { 4 {
išlärımi	i S l { 4 M m i
išmiš	i S m i S
ište	i S t e
ištem	i S t e m
išter	i S t e r
išti	i S t i
ištän	i S t { n
ištır	i S t M r
išä	i S {
išıh	i S M x
išımız	i S M m M z
išımızi	i S M m M z i
išınän	i S M n { n
iššıh	i S S M x
jaal	dZ a 5
jaalar	dZ a 5 a r
jaalikän	dZ a 5 i c { n
jaallar	dZ a 5 l a r
jaallıh	dZ a 5 l M x
jaalıdıh	dZ a 5 M d M x
ji	dZ i
jinis	dZ i n i s
jinisdır	dZ i n i s d M r
jinisi	dZ i n i s i
jinistä	dZ i n i s t {
jinistır	dZ i n i s t M r
jinisä	dZ i n i s {
jinisıdi	dZ i n i s M d i
jinisın	dZ i n i s M n
jinizi	dZ i n i z i
jinizä	dZ i n i z {
julu	dZ u 5 u
jänjür	dZ { n dZ y r
jürä	dZ y 4 {
jılız	dZ M 5 M z
jısğaro	dZ M s G a 4 o
jızğaristan	dZ M z G a 4 i s t a n
jızğaros	dZ M z G a 4 o s
kada	k a d a
kalkhoz	k a 5 x o z
kalkhozdasavkhozda	k a 5 x o z d a s a v x o z d a
kampaniainan	k a m p a n i a i n a n
kamunist	k a m u n i s t
kanfliktmanflikt	k a n f l i k t m a n f l i k t
karabılä	k a 4 a b M 5 {
karagezov	k a 4 a J\ e z o v
karagezovlardan	k a 4 a J\ e z o v l a 4 d a n
karakomda	k a 4 a k o m d a
karakomdan	k a 4 a k o m d a n
karoše	k a 4 o S e
karošeti	k a 4 o S e t i
kartol	k a 4 t o 5
kartola	k a 4 t o 5 a
kartoldur	k a 4 t o 5 d u r
kartoldır	k a 4 t o 5 d M r
kartoli	k a 4 t o 5 i
kartolmartol	k a 4 t o 5 m a 4 t o 5
kartolmartolda	k a 4 t o 5 m a 4 t o 5 d a
kasturkaya	k a s t u 4 k a j a
kef	c e f
kefi	c e f i
kefli	c e f l i
keflänälär	c e f l { n { l { r
keif	c e i f
keiš	c e i S
keišınän	c e i S M n { n
khai	x a i
kharalampovič	x a 4 a 5 a m p o v i tS
kharstan	x a 4 s t a n
khristian	x 4 i s t i a n
khristianlıği	x 4 i s t i a n l M G i
khristianski	x 4 i s t i a n s c i
khristianstvonın	x 4 i s t i a n s t v o n M n
ki	c i
kidä	c i d {
kilisä	c i l i s {
kim	c i m
kimdän	c i m d { n
kimi	c i m i
kimki	c i m c i
kimsä	c i m s {
kimsädä	c i m s { d {
kimsäi	c i m s { i
kimäki	c i m { c i
kimıdi	c i m M d i
kimın	c i m M n
kimındır	c i m M n d M r
kimının	c i m M n M n
kimısi	c i m M s i
kinonia	c i n o n i a
kipra	c i p 4 a
kiprdan	c i p 4 d a n
kiradaidılar	c i 4 a d a i d M 5 a r
kiräjä	c i 4 { dZ {
kislälär	c i s l { l { r
kislälärda	c i s l { l { 4 d a
kislänın	c i s l { n M n
kisläya	c i s l { j a
kismädä	c i s m { d {
kissä	c i s: {
kissädä	c i s: { d {
kissädır	c i s: { d M r
kissäi	c i s: { i
kissälär	c i s: { l { r
kissäläri	c i s: { l { 4 i
kissälärä	c i s: { l { 4 {
kissämız	c i s: { m M z
kissämızdä	c i s: { m M z d {
kissämızi	c i s: { m M z i
kissänın	c i s: { n M n
kissäsi	c i s: { s i
kissäsındä	c i s: { s M n d {
kissäsıni	c i s: { s M n i
kissäsınä	c i s: { s M n {
kissäya	c i s: { j a
kissäyada	c i s: { j a d a
kissäyamissäya	c i s: { j a m i s: { j a
kitlädılär	c i t l { d M 5 { r
kitländi	c i t l { n d i
kladbišaya	k l a d b i S a j a
klasi	k l a s i
klassta	k l a s: t a
klasta	k l a s t a
klubi	k l u b i
klubuna	k l u b u n a
knigada	k n i g a d a
knigalari	k n i g a 5 a 4 i
kohta	k o x t a
kolkhoz	k o 5 x o z
kolkhoza	k o 5 x o z a
kolkhozda	k o 5 x o z d a
kolkhozdan	k o 5 x o z d a n
kolkhozi	k o 5 x o z i
kolkhozlar	k o 5 x o z l a r
kolkhozudi	k o 5 x o z u d i
komunistlärın	k o m u n i s t l { 4 M n
konstantin	k o n s t a n t i n
korozlar	k o 4 o z l a r
kotannar	k o t a n n a r
kotsari	k o t s a 4 i
kovlärın	k o v l { 4 M n
kočari	k o tS a 4 i
krasnadarda	k 4 a s n a d a 4 d a
krayina	k 4 a j i n a
krišalari	k 4 i S a 5 a 4 i
krıš	k 4 M S
krıšali	k 4 M S a 5 i
kulturaida	k u 5 t u 4 a i d a
kädälär	c { d { l { r
kärän	c { 4 { n
käser	c { s e r
käserdılär	c { s e 4 d M 5 { r
käserlär	c { s e 4 l { r
käsierdılär	c { s i e 4 d M 5 { r
käsierlär	c { s i e 4 l { r
käsir	c { s i r
käsirdılär	c { s i 4 d M 5 { r
käsirlär	c { s i 4 l { r
käsirıh	c { s i 4 M x
käsmäh	c { s m { x
käsän	c { s { n
käsändä	c { s { n d {
käsırlär	c { s M 4 l { r
käğıdimäğıdi	c { G M d i m { G M d i
ködä	c 9 d {
kömäg	c 9 m { g
kömäk	c 9 m { k
kömäklimömäkli	c 9 m { k l i m 9 m { k l i
köti	c 9 t i
kötidır	c 9 t i d M r
kötiidi	c 9 t i d i
kötülühıdi	c 9 t y l y x M d i
köv	c 9 v
kövda	c 9 v d a
kövdur	c 9 v d u r
kövdä	c 9 v d {
kövdädä	c 9 v d { d {
kövdäidım	c 9 v d { i d M m
kövdän	c 9 v d { n
kövdändä	c 9 v d { n d {
kövdändırlar	c 9 v d { n d M 4 l a r
kövdür	c 9 v d y r
kövi	c 9 v i
kövli	c 9 v l i
kövlidır	c 9 v l i d M r
kövlär	c 9 v l { r
kövlärdä	c 9 v l { 4 d {
kövlärdän	c 9 v l { 4 d { n
kövlärdändä	c 9 v l { 4 d { n d {
kövläri	c 9 v l { 4 i
kövlärä	c 9 v l { 4 {
kövlärädä	c 9 v l { 4 { d {
kövudi	c 9 v u d i
kövun	c 9 v u n
kövä	c 9 v {
kövüdi	c 9 v y d i
kövümüz	c 9 v y m y z
kövümüzdä	c 9 v y m y z d {
kövümüzüm	c 9 v y m y z y m
kövümüzün	c 9 v y m y z y n
kövün	c 9 v y n
kövüni	c 9 v y n i
kövünun	c 9 v y n u n
kövünän	c 9 v y n { n
kövıdi	c 9 v M d i
kövımızdäkö	c 9 v M m M z d { c 9
kövımızi	c 9 v M m M z i
köčmädılär	c 9 tS m { d M 5 { r
köčmıšlär	c 9 tS m M S l { r
köčti	c 9 tS t i
köčtülär	c 9 tS t y l { r
köšti	c 9 S t i
kümbät	c y m b { t
kümbätä	c y m b { t {
kündä	c y n d {
küčügüdüm	c y tS y J\ y d y m
küčük	c y tS y k
küčükmüčük	c y tS y k m y tS y k
küčüktur	c y tS y k t u r
küčüktürlär	c y tS y k t y 4 l { r
kırlanajağıdıh	k M 4 l a n a dZ a G M d M x
lapatkainan	l a p a t k a i n a n
lapatkalar	l a p a t k a 5 a r
lazım	l a z M m
lazımdägıl	l a z M m d { g M 5
lazımıdi	l a z M m M d i
le	l e
listlärıni	l i s t l { 4 M n i
ma	m a
magazinnar	m a g a z i n n a r
mal	m a 5
mala	m a 5 a
mali	m a 5 i
malitvamızi	m a 5 i t v a m M z i
mallar	m a 5 l a r
mallari	m a 5 l a 4 i
malmul	m a 5 m u 5
mamam	m a m a m
mamamda	m a m a m d a
mamami	m a m a m i
mamamın	m a m a m M n
mamamınan	m a m a m M n a n
mamasi	m a m a s i
manastirda	m a n a s t i 4 d a
manastiri	m a n a s t i 4 i
manetalar	m a n e t a 5 a r
mapi	m a p i
maral	m a 4 a 5
maria	m a 4 i a
maskvada	m a s k v a d a
maskvadadır	m a s k v a d a d M r
maskvadakındän	m a s k v a d a k M n d { n
mašinalarınan	m a S i n a 5 a 4 M n a n
medamorfos	m e d a m o 4 f o s
medučilišada	m e d u tS i l i S a d a
meivälär	m e i v { l { r
mer	m e r
meramanaya	m e 4 a m a n a j a
meriamana	m e 4 i a m a n a
meriamanada	m e 4 i a m a n a d a
meriamanadada	m e 4 i a m a n a d a d a
meriamanadır	m e 4 i a m a n a d M r
meriamanai	m e 4 i a m a n a i
meriamanamıza	m e 4 i a m a n a m M z a
meriamanamızi	m e 4 i a m a n a m M z i
meriamananın	m e 4 i a m a n a n M n
meriamanaya	m e 4 i a m a n a j a
meriamanayada	m e 4 i a m a n a j a d a
meriamanın	m e 4 i a m a n M n
mešälıh	m e S { l M x
millät	m i l: { t
milläti	m i l: { t i
millätiih	m i l: { t i x
millätıni	m i l: { t M n i
mirdan	m i 4 d a n
mlub	m l u b
mm	m:
molaya	m o 5 a j a
molla	m o 5 l a
molladır	m o 5 l a d M r
mraktorunan	m 4 a k t o 4 u n a n
msveči	m s v e tS i
mum	m u m
mumda	m u m d a
mumlar	m u m l a r
mumlari	m u m l a 4 i
mumlarımızi	m u m l a 4 M m M z i
mumlarıni	m u m l a 4 M n i
mumumuzi	m u m u m u z i
mumumızi	m u m u m M z i
mumuni	m u m u n i
muslim	m u s l i m
musulmandır	m u s u 5 m a n d M r
musulmandırl	m u s u 5 m a n d M 4 l
musulmandırlar	m u s u 5 m a n d M 4 l a r
musulmannari	m u s u 5 m a n n a 4 i
musurmandırlar	m u s u 4 m a n d M 4 l a r
musurmanja	m u s u 4 m a n dZ a
musıka	m u s M k a
muzıkada	m u z M k a d a
muzıkainan	m u z M k a i n a n
muzıkalar	m u z M k a 5 a r
mučeniainan	m u tS e n i a i n a n
mučenialarınan	m u tS e n i a 5 a 4 M n a n
mučitolduh	m u tS i t o 5 d u x
mäsällämä	m { s { l: { m {
mäzärdır	m { z { 4 d M r
mäzärlik	m { z { 4 l i k
mäzärliklärä	m { z { 4 l i k l { 4 {
mäzärlär	m { z { 4 l { r
mäzärlärä	m { z { 4 l { 4 {
mäzärlärımızi	m { z { 4 l { 4 M m M z i
mäzärlärıni	m { z { 4 l { 4 M n i
mäzärlık	m { z { 4 l M k
mäzärä	m { z { 4 {
möibätli	m 9 i b { t l i
nablem	n a b l e m
nahıl	n a x M 5
nahıledem	n a x M 5 e d e m
nahılederdi	n a x M 5 e d e 4 d i
nahılederım	n a x M 5 e d e 4 M m
nahıledir	n a x M 5 e d i r
nahıletmıšti	n a x M 5 e t m M S t i
nalogumi	n a 5 o g u m i
namaz	n a m a z
namazımızi	n a m a z M m M z i
namazıni	n a m a z M n i
narmalnaidi	n a 4 m a 5 n a i d i
narmalni	n a 4 m a 5 n i
nastayaši	n a s t a j a S i
nasıl	n a s M 5
nasılki	n a s M 5 c i
navahki	n a v a x c i
navruz	n a v 4 u z
nazıvatsaeder	n a z M v a t s a e d e r
nerdä	n e 4 d {
nerdän	n e 4 d { n
nerdäsıs	n e 4 d { s M s
neräya	n e 4 { j a
nia	n i a
nigola	n i g o 5 a
nikola	n i k o 5 a
nikolao	n i k o 5 a o
nirıh	n i 4 M x
niä	n i {
nišannandıh	n i S a n n a n d M x
nä	n {
näblem	n { b l e m
nädä	n { d {
nädır	n { d M r
näida	n { i d a
näisä	n { i s {
näki	n { c i
näsıl	n { s M 5
näsıldır	n { s M 5 d M r
näsılki	n { s M 5 c i
näsılsıs	n { s M 5 s M s
nätävür	n { t { v y r
nävädä	n { v { d {
nävädäki	n { v { d { c i
nävälärımız	n { v { l { 4 M m M z
nää	n {
o	o
oblasta	o b l a s t a
oblastta	o b l a s t: a
obür	o b y r
obšepit	o b S e p i t
obšepita	o b S e p i t a
obšepiti	o b S e p i t i
obšipıt	o b S i p M t
oda	o d a
odasi	o d a s i
odaya	o d a j a
odä	o d {
odır	o d M r
oh	o x
oherdi	o x e 4 d i
oherdıh	o x e 4 d M x
ohiah	o x i a x
ohian	o x i a n
ohier	o x i e r
ohierdi	o x i e 4 d i
ohierdıh	o x i e 4 d M x
ohierdım	o x i e 4 d M m
ohir	o x i r
ohird	o x i 4 d
ohirdi	o x i 4 d i
ohirdıh	o x i 4 d M x
ohirdılär	o x i 4 d M 5 { r
ohirıh	o x i 4 M x
ohuderdım	o x u d e 4 d M m
ohudi	o x u d i
ohudirdılär	o x u d i 4 d M 5 { r
ohuduh	o x u d u x
ohudular	o x u d u 5 a r
ohudum	o x u d u m
ohumadi	o x u m a d i
ohumah	o x u m a x
ohumai	o x u m a i
ohumaida	o x u m a i d a
ohumami	o x u m a m i
ohumasıni	o x u m a s M n i
ohumaya	o x u m a j a
ohumirlär	o x u m i 4 l { r
ohumišıh	o x u m i S M x
ohumušuh	o x u m u S u x
ohunmıš	o x u n m M S
ohutmirlär	o x u t m i 4 l { r
ohuttular	o x u t: u 5 a r
ohutturierıh	o x u t: u 4 i e 4 M x
ohäbär	o x { b { r
ohärtän	o x { 4 t { n
oinadi	o i n a d i
oinamah	o i n a m a x
oinamahmoinamaği	o i n a m a x m o i n a m a G i
oinamahta	o i n a m a x t a
oinamaya	o i n a m a j a
oinardılär	o i n a 4 d M 5 { r
oiner	o i n e r
oinerlär	o i n e 4 l { r
oinerıh	o i n e 4 M x
oinier	o i n i e r
oinierdılär	o i n i e 4 d M 5 { r
oinierlär	o i n i e 4 l { r
oinierıh	o i n i e 4 M x
oinir	o i n i r
oinirlär	o i n i 4 l { r
oinirıh	o i n i 4 M x
oinmah	o i n m a x
ojahida	o dZ a x i d a
ojahımızdada	o dZ a x M m M z d a d a
ojaği	o dZ a G i
oki	o c i
ola	o 5 a
olabülür	o 5 a b y l y r
olah	o 5 a x
olajah	o 5 a dZ a x
olaki	o 5 a c i
olalar	o 5 a 5 a r
olanda	o 5 a n d a
olansıra	o 5 a n s M 4 a
oldaidılar	o 5 d a i d M 5 a r
oldi	o 5 d i
olduh	o 5 d u x
oldular	o 5 d u 5 a r
oldum	o 5 d u m
oler	o 5 e r
olerdi	o 5 e 4 d i
olerdılär	o 5 e 4 d M 5 { r
olier	o 5 i e r
olierdi	o 5 i e 4 d i
olir	o 5 i r
olirdi	o 5 i 4 d i
olmadi	o 5 m a d i
olmaz	o 5 m a z
olmazda	o 5 m a z d a
olmerdi	o 5 m e 4 d i
olmia	o 5 m i a
olmir	o 5 m i r
olmirdi	o 5 m i 4 d i
olmirlar	o 5 m i 4 l a r
olmiš	o 5 m i S
olmuš	o 5 m u S
olmušım	o 5 m u S M m
olmıš	o 5 m M S
olmıšam	o 5 m M S a m
olmıšti	o 5 m M S t i
olmıšım	o 5 m M S M m
olsun	o 5 s u n
olur	o 5 u r
on	o n
ona	o n a
onalti	o n a 5 t i
onaltidır	o n a 5 t i d M r
onarda	o n a 4 d a
onbeš	o n b e S
onbir	o n b i r
ondan	o n d a n
oneddi	o n e d: i
oni	o n i
onida	o n i d a
onnan	o n n a n
onnanda	o n n a n d a
onnar	o n n a r
onnara	o n n a 4 a
onnarda	o n n a 4 d a
onnari	o n n a 4 i
onnarida	o n n a 4 i d a
onnarım	o n n a 4 M m
onnarın	o n n a 4 M n
onnarınan	o n n a 4 M n a n
onnarınanda	o n n a 4 M n a n d a
onnarında	o n n a 4 M n d a
onsäkkiz	o n s { k c i z
ontänačen	o n t { n a tS e n
onun	o n u n
onunji	o n u n dZ i
onučun	o n u tS u n
onučunda	o n u tS u n d a
oradan	o 4 a d a n
oralar	o 4 a 5 a r
oralara	o 4 a 5 a 4 a
oralarada	o 4 a 5 a 4 a d a
oralarda	o 4 a 5 a 4 d a
oralardan	o 4 a 5 a 4 d a n
oranın	o 4 a n M n
orda	o 4 d a
ordada	o 4 d a d a
ordaikän	o 4 d a i c { n
ordan	o 4 d a n
ordanda	o 4 d a n d a
ortasındaih	o 4 t a s M n d a i x
orya	o 4 j a
otarierıh	o t a 4 i e 4 M x
otarli	o t a 4 l i
ottuz	o t: u z
ottuzunji	o t: u z u n dZ i
oturerlär	o t u 4 e 4 l { r
oturerıh	o t u 4 e 4 M x
oturierlär	o t u 4 i e 4 l { r
oturir	o t u 4 i r
oturirdıh	o t u 4 i 4 d M x
oturirıh	o t u 4 i 4 M x
otuz	o t u z
ovah	o v a x
ovahıtta	o v a x M t: a
oyan	o j a n
oyana	o j a n a
oyani	o j a n i
oyanki	o j a n c i
oğlan	o G l a n
oğlanda	o G l a n d a
oğlandan	o G l a n d a n
oğlandırlar	o G l a n d M 4 l a r
oğlani	o G l a n i
oğlannardırlar	o G l a n n a 4 d M 4 l a r
oğlanıdi	o G l a n M d i
oğlanın	o G l a n M n
oğli	o G l i
oğlum	o G l u m
oğulušah	o G u 5 u S a x
oğulušağımızada	o G u 5 u S a G M m M z a d a
oğulušağınan	o G u 5 u S a G M n a n
pak	p a k
pakamiz	p a k a m i z
palaženialar	p a 5 a Z e n i a 5 a r
pantiitslär	p a n t i t s l { r
papam	p a p a m
park	p a 4 k
partiaya	p a 4 t i a j a
pas	p a s
paskainan	p a s k a i n a n
paskevičıdi	p a s c e v i tS M d i
peida	p e i d a
peinir	p e i n i r
peinır	p e i n M r
pentsia	p e n t s i a
pentsianer	p e n t s i a n e r
perioda	p e 4 i o d a
persia	p e 4 s i a
pervıdä	p e 4 v M d {
pečkoda	p e tS k o d a
pismoi	p i s m o i
polelar	p o 5 e l a r
pontos	p o n t o s
pr_adam	a d a m
pr_ajarlarınan	a dZ a 4 l a 4 M n a n
pr_ağačın	a G a tS M n
pr_babama	b a b a m a
pr_beš	b e S
pr_biz	b i z
pr_bizım	b i z M m
pr_bizın	b i z M n
pr_bu	b u
pr_bänim	b { n i m
pr_dilın	d i l M n
pr_eddi	e d: i
pr_elä	e l {
pr_eč	e tS
pr_gün	J\ y n
pr_inäk	i n { k
pr_ki	c i
pr_kövdän	c 9 v d { n
pr_noo	n o
pr_nä	n {
pr_o	o
pr_ohurlar	o x u 4 l a r
pr_oki	o c i
pr_onnar	o n n a r
pr_onnardan	o n n a 4 d a n
pr_onun	o n u n
pr_orda	o 4 d a
pr_sağ	s a G
pr_soradan	s o 4 a d a n
pr_sänä	s { n {
pr_turtsianın	t u 4 t s i a n M n
pr_valik	v a l i k
pr_yahši	j a x S i
pr_yapi	j a p i
pr_čučugüdüm	tS u tS u J\ y d y m
pr_čätın	tS { t i n
pr_šei	S e i
pr_šindi	S i n d i
prablemali	p 4 a b l e m a 5 i
prahmadıh	p 4 a x m a d M x
prahmirıh	p 4 a x m i 4 M x
prahtıh	p 4 a x t M x
prahtılar	p 4 a x t M 5 a r
pravadit	p 4 a v a d i t
pravaslavnidır	p 4 a v a s l a v n i d M r
pravaslavniih	p 4 a v a s l a v n i x
prazdnikdır	p 4 a z d n i k d M r
prazdnikläri	p 4 a z d n i k l { 4 i
prazdniklärıni	p 4 a z d n i k l { 4 M n i
prazdniktır	p 4 a z d n i k t M r
prazdnikımızda	p 4 a z d n i k M m M z d a
praznik	p 4 a z n i k
prazniklarda	p 4 a z n i k l a 4 d a
praznikımız	p 4 a z n i k M m M z
praznikın	p 4 a z n i k M n
predkılarda	p 4 e d k M 5 a 4 d a
predkılarımıs	p 4 e d k M 5 a 4 M m M s
predkılärım	p 4 e d k M 5 { 4 M m
predokların	p 4 e d o k l a 4 M n
predsedatelıdi	p 4 e d s e d a t e l M d i
prieh	p 4 i e x
prirodadada	p 4 i 4 o d a d a d a
prirodasi	p 4 i 4 o d a s i
prirodaya	p 4 i 4 o d a j a
pročim	p 4 o tS i m
puh	p u x
pul	p u 5
pula	p u 5 a
puliinän	p u 5 i n { n
pulumuz	p u 5 u m u z
pulunan	p u 5 u n a n
punğar	p u n G a r
pänčoidi	p { n tS o i d i
pıhardır	p M x a 4 d M r
pıharlar	p M x a 4 l a r
pıhartmadılar	p M x a 4 t m a d M 5 a r
pıharımız	p M x a 4 M m M z
pınğar	p M n G a r
raditellarida	4 a d i t e l: a 4 i d a
rasgäldi	4 a s J\ { l d i
rassiada	4 a s: i a d a
rassiadadırlar	4 a s: i a d a d M 4 l a r
rassiadaidım	4 a s: i a d a i d M m
rassiadan	4 a s: i a d a n
rassiaya	4 a s: i a j a
rassıa	4 a s: M a
ravestniklärım	4 a v e s t n i k l { 4 M m
rayona	4 a j o n a
rayonda	4 a j o n d a
rayondır	4 a j o n d M r
rayoni	4 a j o n i
rayonunda	4 a j o n u n d a
razi	4 a z i
raziidıh	4 a z i d M x
raznitsasi	4 a z n i t s a s i
razvitı	4 a z v i t M
religiai	4 e l i J\ i a i
religialari	4 e l i J\ i a 5 a 4 i
religialarıni	4 e l i J\ i a 5 a 4 M n i
religian	4 e l i J\ i a n
religiasıni	4 e l i J\ i a s M n i
rodinamıza	4 o d i n a m M z a
rubigımız	4 u b i g M m M z
rusetä	4 u s e t {
ruski	4 u s c i
russkia	4 u s: c i a
russkidır	4 u s: c i d M r
rämätä	4 { m { t {
saabi	s a b i
saapsıs	s a p s M s
saat	s a t
sabah	s a b a x
sabahtan	s a b a x t a n
sabahısidä	s a b a x M s i d {
sabağaačen	s a b a G a tS e n
sabağačet	s a b a G a tS e t
sabağısi	s a b a G M s i
sahladılar	s a x l a d M 5 a r
sahlamirdi	s a x l a m i 4 d i
sahliaidılar	s a x l i a i d M 5 a r
sahlierıh	s a x l i e 4 M x
sahlirıh	s a x l i 4 M x
sai	s a i
saidılar	s a i d M 5 a r
sailierdıh	s a i l i e 4 d M x
sailir	s a i l i r
saimainan	s a i m a i n a n
saldatlara	s a 5 d a t l a 4 a
satierlär	s a t i e 4 l { r
satierıh	s a t i e 4 M x
satirıh	s a t i 4 M x
satirım	s a t i 4 M m
savetskının	s a v e t s k M n M n
savkhoza	s a v x o z a
savkhozda	s a v x o z d a
savkhozdada	s a v x o z d a d a
savkhozudi	s a v x o z u d i
savxozda	s a v o z d a
sayuza	s a j u z a
sağ	s a G
sağir	s a G i r
sağmaya	s a G m a j a
sağolsun	s a G o 5 s u n
sedmoidan	s e d m o i d a n
sek	s e k
selektsionnaya	s e l e k t s i o n n a j a
selskokhazyaistvoinän	s e l s k o x a z j a i s t v o i n { n
semeiniidi	s e m e i n i d i
semiaya	s e m i a j a
semyada	s e m j a d a
semyadır	s e m j a d M r
semyai	s e m j a i
semyainan	s e m j a i n a n
semyalari	s e m j a 5 a 4 i
semyalaridır	s e m j a 5 a 4 i d M r
semyalarımız	s e m j a 5 a 4 M m M z
semyam	s e m j a m
semyamız	s e m j a m M z
semyasi	s e m j a s i
semyasına	s e m j a s M n a
semyasında	s e m j a s M n d a
semyasıni	s e m j a s M n i
shindidä	s x i n d i d {
siftäkının	s i f t { k M n M n
sikh	s i x
sira	s i 4 a
sistemada	s i s t e m a d a
sistemainan	s i s t e m a i n a n
situatsiası	s i t u a t s i a s M
siz	s i z
sizlärınän	s i z l { 4 M n { n
sizä	s i z {
sizädä	s i z { d {
skholiosa	s x o 5 i o s a
skladlar	s k l a d l a r
slabi	s l a b i
sora	s o 4 a
sorada	s o 4 a d a
soradan	s o 4 a d a n
soradanda	s o 4 a d a n d a
soraidi	s o 4 a i d i
soram	s o 4 a m
soramda	s o 4 a m d a
sorarda	s o 4 a 4 d a
sortoučastokta	s o 4 t o u tS a s t o k t a
sorušierıh	s o 4 u S i e 4 M x
soyuh	s o j u x
soyuhda	s o j u x d a
soyuğudi	s o j u G u d i
spiridon	s p i 4 i d o n
spiridonudi	s p i 4 i d o n u d i
sportdarbaz	s p o 4 t d a 4 b a z
sportzali	s p o 4 t z a 5 i
stalinın	s t a 5 i n M n
stapalariinän	s t a p a 5 a 4 i n { n
staraemsa	s t a 4 a e m s a
stavnyalari	s t a v n j a 5 a 4 i
stavropol	s t a v 4 o p o 5
staži	s t a Z i
stažiinan	s t a Z i n a n
stola	s t o 5 a
stolda	s t o 5 d a
stollar	s t o 5 l a r
stroi	s t 4 o i
stroyunda	s t 4 o j u n d a
su	s u
suhuma	s u x u m a
suhumdan	s u x u m d a n
sui	s u i
sular	s u 5 a r
sulari	s u 5 a 4 i
susuzluh	s u s u z l u x
suyačäktıh	s u j a tS { k t M x
suyu	s u j u
svadbalari	s v a d b a 5 a 4 i
svannarınan	s v a n n a 4 M n a n
syolanın	s j o 5 a n M n
säkiz	s { c i z
säkkiz	s { k c i z
säkkizisında	s { k c i z i s M n d a
säkkizuyz	s { k c i z u j z
säkkizındä	s { k c i z M n d {
säksän	s { k s { n
säläm	s { l { m
sän	s { n
sändän	s { n d { n
sänä	s { n {
sänädä	s { n { d {
särdıh	s { 4 d M x
sävdılär	s { v d M 5 { r
säverdılär	s { v e 4 d M 5 { r
säverıh	s { v e 4 M x
sävierdıh	s { v i e 4 d M x
sävierdılär	s { v i e 4 d M 5 { r
sävierıh	s { v i e 4 M x
sävinerlär	s { v i n e 4 l { r
säväjäih	s { v { dZ { i x
sävınerdıh	s { v M n e 4 d M x
sävınierdıh	s { v M n i e 4 d M x
sävınierlär	s { v M n i e 4 l { r
sävınierıh	s { v M n i e 4 M x
sävınirlär	s { v M n i 4 l { r
sävınmäya	s { v M n m { j a
sävınä	s { v M n {
sävınčli	s { v M n tS l i
sögmäh	s 9 g m { x
söiler	s 9 i l e r
söilerıh	s 9 i l e 4 M x
söiliah	s 9 i l i a x
söilialar	s 9 i l i a 5 a r
söiliamerıh	s 9 i l i a m e 4 M x
söilian	s 9 i l i a n
söilierlär	s 9 i l i e 4 l { r
söilierıh	s 9 i l i e 4 M x
söilir	s 9 i l i r
söilirdıh	s 9 i l i 4 d M x
söilirdılär	s 9 i l i 4 d M 5 { r
söilirdın	s 9 i l i 4 d M n
söilirlär	s 9 i l i 4 l { r
söiliräm	s 9 i l i 4 { m
söilirıh	s 9 i l i 4 M x
söilirım	s 9 i l i 4 M m
söilämirıh	s 9 i l { m i 4 M x
söilämädım	s 9 i l { m { d M m
söilämäh	s 9 i l { m { x
söilänmir	s 9 i l { n m i r
söilärım	s 9 i l { 4 M m
söktülä	s 9 k t y l {
söktülär	s 9 k t y l { r
sökühtür	s 9 c y x t y r
söndür	s 9 n d y r
sös	s 9 s
söz	s 9 z
sözlär	s 9 z l { r
sözläri	s 9 z l { 4 i
sözläriinän	s 9 z l { 4 i n { n
sözlärımızä	s 9 z l { 4 M m M z {
sözünän	s 9 z y n { n
süd	s y d
südli	s y d l i
sürerdılär	s y 4 e 4 d M 5 { r
sıhirdılar	s M x i 4 d M 5 a r
sıhtırerdılär	s M x t M 4 e 4 d M 5 { r
sılıhčidır	s M 5 M x tS i d M r
sıra	s M 4 a
sıradan	s M 4 a d a n
sıralari	s M 4 a 5 a 4 i
sırasi	s M 4 a s i
sırasında	s M 4 a s M n d a
sıčırierlär	s M tS M 4 i e 4 l { r
tah	t a x
tahtalari	t a x t a 5 a 4 i
tahıl	t a x M 5
tamam	t a m a m
tamamda	t a m a m d a
tandır	t a n d M r
tandıra	t a n d M 4 a
tandırda	t a n d M 4 d a
tandırlar	t a n d M 4 l a r
tango	t a n g o
tantslar	t a n t s l a r
tanušlandılar	t a n u S l a n d M 5 a r
tanıdi	t a n M d i
tanımerdi	t a n M m e 4 d i
tanıšlandıh	t a n M S l a n d M x
tanıšlandılar	t a n M S l a n d M 5 a r
tanıšlandım	t a n M S l a n d M m
tanıšlanirdıh	t a n M S l a n i 4 d M x
tayuh	t a j u x
tekhnikam	t e x n i k a m
tekhnikamız	t e x n i k a m M z
telıni	t e l M n i
teretoriasında	t e 4 e t o 4 i a s M n d a
teretriasında	t e 4 e t 4 i a s M n d a
terit	t e 4 i t
teritoriada	t e 4 i t o 4 i a d a
teritoriasında	t e 4 i t o 4 i a s M n d a
tez	t e z
tezdän	t e z d { n
tian	t i a n
tiflisa	t i f l i s a
tiflisdä	t i f l i s d {
tiflisdädä	t i f l i s d { d {
tiflisdän	t i f l i s d { n
tiflistan	t i f l i s t a n
tiflistanda	t i f l i s t a n d a
tiflistä	t i f l i s t {
tiflistän	t i f l i s t { n
tiflisä	t i f l i s {
tiiflistädä	t i f l i s t { d {
tipi	t i p i
todor	t o d o r
tohli	t o x l i
tohlimohli	t o x l i m o x l i
tokunan	t o k u n a n
tomari	t o m a 4 i
toplamaya	t o p l a m a j a
toplaner	t o p l a n e r
toplanerlär	t o p l a n e 4 l { r
toplanier	t o p l a n i e r
toplanierlär	t o p l a n i e 4 l { r
toplierıh	t o p l i e 4 M x
toprah	t o p 4 a x
torpah	t o 4 p a x
torpahlar	t o 4 p a x l a r
torpahlari	t o 4 p a x l a 4 i
torpahmorpah	t o 4 p a x m o 4 p a x
torpahmorpağınan	t o 4 p a x m o 4 p a G M n a n
torpahta	t o 4 p a x t a
torpahtan	t o 4 p a x t a n
torpahıdi	t o 4 p a x M d i
torpaği	t o 4 p a G i
torpağım	t o 4 p a G M m
torpağımız	t o 4 p a G M m M z
torpağın	t o 4 p a G M n
torpağına	t o 4 p a G M n a
torpağınan	t o 4 p a G M n a n
torunda	t o 4 u n d a
torunnar	t o 4 u n n a r
torunnarım	t o 4 u n n a 4 M m
torunnarımız	t o 4 u n n a 4 M m M z
torunnarımızda	t o 4 u n n a 4 M m M z d a
toy	t o j
toylarına	t o j l a 4 M n a
toymoyuna	t o j m o j u n a
tože	t o Z e
trabzona	t 4 a b z o n a
trabzonda	t 4 a b z o n d a
traditsiai	t 4 a d i t s i a i
traktorda	t 4 a k t o 4 d a
traktori	t 4 a k t o 4 i
traktorist	t 4 a k t o 4 i s t
traktorunan	t 4 a k t o 4 u n a n
trapezondadan	t 4 a p e z o n d a d a n
trudodenä	t 4 u d o d e n {
trudunan	t 4 u d u n a n
tsalga	t s a 5 g a
tsalgaya	t s a 5 g a j a
tsalka	t s a 5 k a
tsalkada	t s a 5 k a d a
tsalkadada	t s a 5 k a d a d a
tsalkadandır	t s a 5 k a d a n d M r
tsalkaliidi	t s a 5 k a 5 i d i
tsalkanın	t s a 5 k a n M n
tsalkaya	t s a 5 k a j a
tsarlar	t s a 4 l a r
tsementi	t s e m e n t i
tufli	t u f l i
turbine	t u 4 b i n e
turetskidä	t u 4 e t s c i d {
turkiadan	t u 4 c i a d a n
turklar	t u 4 k l a r
turkča	t u 4 k tS a
turtsia	t u 4 t s i a
turtsiada	t u 4 t s i a d a
turtsiadan	t u 4 t s i a d a n
turtsiainan	t u 4 t s i a i n a n
turtsialar	t u 4 t s i a 5 a r
turtsiaya	t u 4 t s i a j a
tyotyam	t j o t j a m
tzalgadan	t z a 5 g a d a n
tzalganın	t z a 5 g a n M n
täk	t { k
täkkisädä	t { k c i s { d {
täkkisädän	t { k c i s { d { n
täkım	t { k M m
tämüz	t { m y z
tärsondadır	t { 4 s o n d a d M r
täräf	t { 4 { f
täräfä	t { 4 { f {
täräfındän	t { 4 { f M n d { n
täräfınä	t { 4 { f M n {
täzä	t { z {
täzädän	t { z { d { n
täzädır	t { z { d M r
täzäklär	t { z { k l { r
täzälädıh	t { z { l { d M x
täzälärä	t { z { l { 4 {
täzäya	t { z { j a
türk	t y 4 k
türki	t y 4 c i
türkiinän	t y 4 c i n { n
türkjä	t y 4 k dZ {
türkülär	t y 4 c y l { r
türküläri	t y 4 c y l { 4 i
türküsi	t y 4 c y s i
türkčä	t y 4 k tS {
ui_ai	S e i
ui_ajından	S i n d i
ui_ambelä	a m b e l {
ui_anama	a n a m a
ui_anelä	a n e l {
ui_ataanam	a t a n a m
ui_belä	b e l {
ui_birdä	b i 4 d {
ui_biräm	b i 4 { m
ui_biz	b i z
ui_bizım	b i z M m
ui_bizım_halh	b i z M m x a 5 x
ui_buidi	b u i d i
ui_buyani	b u j a n i
ui_böyuk	b 9 j u k
ui_bülem	b y l e m
ui_daa	d a
ui_dedılär	d e d M 5 { r
ui_diem	d i e m
ui_durdular	d u 4 d u l a r
ui_dzalgada	d z a 5 g a d a
ui_eddi	e d: i
ui_edirlär	e d i 4 l { r
ui_elädır	e l { d M r
ui_erdädır	e 4 d { d M r
ui_ey	e j
ui_genä	J\ e n {
ui_getti	J\ e t: i
ui_gidärım	J\ i d { 4 M m
ui_gäldım	J\ { l d M m
ui_gälierlär	J\ { l i e 4 l { r
ui_günnär	J\ y n n { r
ui_güzäl	J\ y z { l
ui_hä	x {
ui_iš	i S
ui_išlier	i S l i e 4
ui_išlierdılär	i S l i 4 d M 5 { r
ui_ka	k a
ui_khara	x a 4 a
ui_ki	c i
ui_kövümüzdä	c 9 v y m y z d {
ui_mazanti	m a z a n t i
ui_nač	n a tS
ui_nä	n {
ui_näblem	n { b l e m
ui_näsıl	n { s M 5
ui_oldular	o 5 d u 5 a r
ui_olur	o 5 u r
ui_onnarda	o n n a n d a
ui_onučun	o n u tS u n
ui_orda	o 4 d a
ui_sayuzda	s a j u z d a
ui_semyasiinän	s e m j a s i n { n
ui_säkkiz	s { k c i z
ui_tezındän	t e z M n d { n
ui_tsalkanın	t s a 5 k a n M n
ui_tsalkaya	t s a 5 k a j a
ui_tsalkaya_gäldılär	t s a 5 k a j a J\ { l d M 5 { r
ui_urus	u 4 u s
ui_ušah	u S a x
ui_var	v a r
ui_varıdi	v a 4 M d i
ui_yašianda	j a S i a n d a
ui_yaširdıh	j a S i 4 d M x
ui_äbämız	{ b { m M z
ui_äkirıh	{ c i 4 M x
ui_äp	{ p
ui_äptä	{ p t {
ui_ärištä	{ 4 i S t a
ui_üstünä	y tS t { n {
ui_čalıširlär	tS a 5 M S i 4 l { r
ui_čoğ	tS o G
ui_ğazanti	G a z a n t i
ui_ğačtılar	G a tS t M 5 a r
ui_ğoyun	G o j u n
ui_šindidä	S i n d i d {
uji	u dZ i
ujuz	u dZ u z
ukrainadanda	u k 4 a i n a d a n d a
ukrainaya	u k 4 a i n a j a
ulitsada	u 5 i t s a d a
ulitsaidi	u 5 i t s a i d i
ulitsalar	u 5 i t s a 5 a r
umaya	u m a j a
unudirdıh	u n u d i 4 d M x
unutmam	u n u t m a m
unutmušum	u n u t m u S u m
unuttum	u n u t: u m
urokta	u 4 o k t a
urum	u 4 u m
urumdurlar	u 4 u m d u 4 l a r
urumja	u 4 u m dZ a
urumjai	u 4 u m dZ a i
urumlar	u 4 u m l a r
urumlardan	u 4 u m l a 4 d a n
urumlari	u 4 u m l a 4 i
urumların	u 4 u m l a 4 M n
urumlarınan	u 4 u m l a 4 M n a n
urumluh	u 4 u m l u x
urumluğunanda	u 4 u m l u G u n a n d a
urus	u 4 u s
uruset	u 4 u s e t
urusetta	u 4 u s e t: a
urusettä	u 4 u s e t: {
urusettädır	u 4 u s e t: { d M r
urusettän	u 4 u s e t: { n
urusettändä	u 4 u s e t: { n d {
urusetä	u 4 u s e t {
urusudi	u 4 u s u d i
urusun	u 4 u s u n
urusča	u 4 u s tS a
urusčada	u 4 u s tS a d a
urusčai	u 4 u s tS a i
urusčainan	u 4 u s tS a i n a n
urušai	u 4 u S a i
ushahlarımız	u s x a x l a 4 M m M z
ushahlarımızda	u s x a x l a 4 M m M z d a
uslovialar	u s l o v i a 5 a r
usul	u s u 5
uzah	u z a x
uzun	u z u n
učitellär	u tS i t e l: { r
učitellärdä	u tS i t e l: { 4 d {
uša	u S a
ušah	u S a x
ušahlar	u S a x l a r
ušahlarda	u S a x l a 4 d a
ušahlardan	u S a x l a 4 d a n
ušahlari	u S a x l a 4 i
ušahlarida	u S a x l a 4 i d a
ušahlarımi	u S a x l a 4 M m i
ušahlarımız	u S a x l a 4 M m M z
ušahlarınan	u S a x l a 4 M n a n
ušahlarıni	u S a x l a 4 M n i
ušahmušah	u S a x m u S a x
ušahtır	u S a x t M r
ušahıdılar	u S a x M d M 5 a r
ušaği	u S a G i
ušağiam	u S a G i a m
ušağıdi	u S a G M d i
ušağıdım	u S a G M d M m
ušağım	u S a G M m
ušağımda	u S a G M m d a
uže	u Z e
vadadır	v a d a d M r
vadä	v a d {
vahıt	v a x M t
vals	v a 5 s
var	v a r
vardı	v a 4 d M
vardır	v a 4 d M r
vardırlar	v a 4 d M 4 l a r
varıdi	v a 4 M d i
važnidır	v a Z n i d M r
vekta	v e k t a
verdi	v e 4 d i
verdılär	v e 4 d M 5 { r
verer	v e 4 e r
vererdi	v e 4 e 4 d i
vererlär	v e 4 e 4 l { r
verierlär	v e 4 i e 4 l { r
verierıh	v e 4 i e 4 M x
verirdi	v e 4 i 4 d i
verirdılär	v e 4 i 4 d M 5 { r
verirlär	v e 4 i 4 l { r
verirım	v e 4 i 4 M m
vermer	v e 4 m e 4
vermerdi	v e 4 m e 4 d i
vermerdılar	v e 4 m e 4 d M 5 a r
vermerıh	v e 4 m e 4 M x
vermiajäih	v e 4 m i a dZ { i x
vermierdi	v e 4 m i e 4 d i
vermierdılär	v e 4 m i e 4 d M 5 { r
versın	v e 4 s M n
verä	v e 4 {
veräjäih	v e 4 { dZ { i x
verın	v e 4 M n
vethi	v e t x i
volyalarına	v o 5 j a 5 a 4 M n a
vosemdesyat	v o s e m d e s j a t
vozrasta	v o z 4 a s t a
vurah	v u 4 a x
vurdularsa	v u 4 d u 5 a 4 s a
vurerıh	v u 4 e 4 M x
vädä	v { d {
vädädä	v { d { d {
vädäsındä	v { d { s M n d {
vımızdä	v M m M z d {
yaan	j a n
yada	j a d a
yahamah	j a x a m a x
yaher	j a x e r
yaherdıh	j a x e 4 d M x
yaherlär	j a x e 4 l { r
yaherıh	j a x e 4 M x
yahierdıh	j a x i e 4 d M x
yahierdılär	j a x i e 4 d M 5 { r
yahierlär	j a x i e 4 l { r
yahierıh	j a x i e 4 M x
yahin	j a x i n
yahir	j a x i r
yahirlar	j a x i 4 l a r
yahirlär	j a x i 4 l { r
yahirıh	j a x i 4 M x
yahirım	j a x i 4 M m
yahmah	j a x m a x
yahshi	j a x s x i
yahti	j a x t i
yahtıhtan	j a x t M x t a n
yahtılar	j a x t M 5 a r
yahtım	j a x t M m
yahın	j a x M n
yahındır	j a x M n d M r
yahši	j a x S i
yahšidır	j a x S i d M r
yahšiidi	j a x S i d i
yahšiya	j a x S i j a
yahšı	j a x S M
yailalar	j a i l a 5 a r
yalnayah	j a 5 n a j a x
yana	j a n a
yandan	j a n d a n
yanem	j a n e m
yaniki	j a n i c i
yanirdi	j a n i 4 d i
yanmir	j a n m i r
yanıma	j a n M m a
yanına	j a n M n a
yanında	j a n M n d a
yanındada	j a n M n d a d a
yanından	j a n M n d a n
yap	j a p
yaperdılär	j a p e 4 d M 5 { r
yaperlär	j a p e 4 l { r
yaperıh	j a p e 4 M x
yapi	j a p i
yapida	j a p i d a
yapii	j a p i
yapir	j a p i r
yapmaya	j a p m a j a
yapmıš	j a p m M S
yaptıh	j a p t M x
yaptılar	j a p t M 5 a r
yaptılarıdi	j a p t M 5 a 4 M d i
yaptım	j a p t M m
yapıda	j a p M d a
yapıdan	j a p M d a n
yapılar	j a p M 5 a r
yapılarda	j a p M 5 a 4 d a
yapılardır	j a p M 5 a 4 d M r
yapılari	j a p M 5 a 4 i
yapılarıdi	j a p M 5 a 4 M d i
yapılarındada	j a p M 5 a 4 M n d a d a
yapıldi	j a p M 5 d i
yapımız	j a p M m M z
yapımızın	j a p M m M z M n
yapısi	j a p M s i
yapısında	j a p M s M n d a
yari	j a 4 i
yarısi	j a 4 M s i
yarısından	j a 4 M s M n d a n
yashadıh	j a s x a d M x
yasherlär	j a s x e 4 l { r
yat	j a t
yatir	j a t i r
yatmir	j a t m i r
yatırırdılar	j a t M 4 M 4 d M 5 a r
yaval	j a v a 5
yavaš	j a v a S
yayan	j a j a n
yazdi	j a z d i
yazerdıh	j a z e 4 d M x
yazi	j a z i
yaziräm	j a z i 4 { m
yazmasi	j a z m a s i
yazmasıni	j a z m a s M n i
yazmağınan	j a z m a G M n a n
yazıgi	j a z M J\ i
yazıgidä	j a z M J\ i d {
yazıktır	j a z M k t M r
yazılmıš	j a z M 5 m M S
yazın	j a z M n
yağ	j a G
yağier	j a G i e r
yağierdi	j a G i e 4 d i
yağir	j a G i r
yağirdi	j a G i 4 d i
yağirdiisä	j a G i 4 d i s {
yağıš	j a G M S
yaš	j a S
yaša	j a S a
yašadi	j a S a d i
yašadiisä	j a S a d i s {
yašadıh	j a S a d M x
yašadılar	j a S a d M 5 a r
yašamah	j a S a m a x
yašamahlar	j a S a m a x l a r
yašamahta	j a S a m a x t a
yašamahıdi	j a S a m a x M d i
yašamainan	j a S a m a i n a n
yašamama	j a S a m a m a
yašamasi	j a S a m a s i
yašamaya	j a S a m a j a
yašamierdi	j a S a m i e 4 d i
yašamir	j a S a m i r
yašamirdi	j a S a m i 4 d i
yašamıšam	j a S a m M S a m
yašamıšlar	j a S a m M S l a r
yašatti	j a S a t: i
yašerdi	j a S e 4 d i
yašerdıh	j a S e 4 d M x
yašerdılar	j a S e 4 d M 5 a r
yašerdılär	j a S e 4 d M 5 { r
yašerlär	j a S e 4 l { r
yašerıh	j a S e 4 M x
yašiabülirıh	j a S i a b y l i 4 M x
yašiajah	j a S i a dZ a x
yašialär	j a S i a 5 { r
yašiamerdi	j a S i a m e 4 d i
yašiamierdılär	j a S i a m i e 4 d M 5 { r
yašiamirdılär	j a S i a m i 4 d M 5 { r
yašier	j a S i e r
yašierdi	j a S i e 4 d i
yašierdıh	j a S i e 4 d M x
yašierdılar	j a S i e 4 d M 5 a r
yašierdılär	j a S i e 4 d M 5 { r
yašierlar	j a S i e 4 l a r
yašierlär	j a S i e 4 l { r
yašierıh	j a S i e 4 M x
yašierım	j a S i e 4 M m
yašimız	j a S i m M z
yašir	j a S i r
yaširdi	j a S i 4 d i
yaširdıh	j a S i 4 d M x
yaširdılär	j a S i 4 d M 5 { r
yaširlär	j a S i 4 l { r
yaširıh	j a S i 4 M x
yaširım	j a S i 4 M m
yašta	j a S t a
yašıerdım	j a S M e 4 d M m
yašımda	j a S M m d a
yašında	j a S M n d a
yašındadır	j a S M n d a d M r
yašındaidi	j a S M n d a i d i
yelda	j e l d a
yoh	j o x
yohari	j o x a 4 i
yohsa	j o x s a
yohsam	j o x s a m
yohtur	j o x t u r
yol	j o 5
yola	j o 5 a
yolda	j o 5 d a
yoldan	j o 5 d a n
yoldašlarınan	j o 5 d a S l a 4 M n a n
yoldašımınan	j o 5 d a S M m M n a n
yoldur	j o 5 d u r
yoli	j o 5 i
yolladılar	j o 5 l a d M 5 a r
yollamah	j o 5 l a m a x
yollamien	j o 5 l a m i e n
yollar	j o 5 l a r
yollarda	j o 5 l a 4 d a
yollari	j o 5 l a 4 i
yoluma	j o 5 u m a
yorios	j o 4 i o s
yoryos	j o 4 j o s
yoğudi	j o G u d i
yoğıdi	j o G M d i
yumurta	j u m u 4 t a
yumurtainan	j u m u 4 t a i n a n
yumurtalar	j u m u 4 t a 5 a r
yumurtalari	j u m u 4 t a 5 a 4 i
yumurtamumurtainan	j u m u 4 t a m u m u 4 t a i n a n
yunanistana	j u n a n i s t a n a
yuz	j u z
za	z a
zanidırım	z a n i d M 4 M m
zatik	z a t i k
zatošto	z a t o S t o
zavettan	z a v e t: a n
zemlyankaidi	z e m l j a n k a i d i
zemlyankalarda	z e m l j a n k a 5 a 4 d a
zemlyankalarıdi	z e m l j a n k a 5 a 4 M d i
zemlänkalar	z e m l { n k a 5 a r
ziar	z i a r
ziarat	z i a 4 a t
ziarata	z i a 4 a t a
ziaratlar	z i a 4 a t l a r
ziaratlara	z i a 4 a t l a 4 a
ziaratlarada	z i a 4 a t l a 4 a d a
ziaratlarda	z i a 4 a t l a 4 d a
ziaratların	z i a 4 a t l a 4 M n
ziarattadır	z i a 4 a t: a d M r
ziarattan	z i a 4 a t: a n
ziarattır	z i a 4 a t: M r
ziaratımız	z i a 4 a t M m M z
ziaratın	z i a 4 a t M n
znamyalar	z n a m j a 5 a r
zonadadır	z o n a d a d M r
zonanın	z o n a n M n
zorunan	z o 4 u n a n
zängin	z { n J\ i n
äbä	{ b {
äbäläri	{ b { l { 4 i
äbälärim	{ b { l { 4 i m
äbälärımız	{ b { l { 4 M m M z
äbäm	{ b { m
äbämäbä	{ b { m { b {
äbämız	{ b { m M z
ädät	{ d { t
ädätlärınän	{ d { t l { 4 M n { n
äglärdi	{ g l { 4 d i
ägär	{ J\ { r
äker	{ c e r
äkerdıh	{ c e 4 d M x
äkerdılär	{ c e 4 d M 5 { r
äkerlär	{ c e 4 l { r
äkierlär	{ c i e 4 l { r
äkierıh	{ c i e 4 M x
äkiirım	{ c i 4 M m
äkir	{ c i r
äkirdıh	{ c i 4 d M x
äkirlär	{ c i 4 l { r
äkirıh	{ c i 4 M x
äkirım	{ c i 4 M m
äkmäk	{ k m { k
äkmäktırl	{ k m { k t M 4 l
äkmäkčılıdi	{ k m { k tS M 5 M d i
äkmäya	{ k m { j a
äksi	{ k s i
äksia	{ k s i a
äksidır	{ k s i d M r
äksiidi	{ k s i d i
äksik	{ k s i k
äksılärınän	{ k s M 5 { 4 M n { n
älli	{ l: i
älläriinän	{ l: { 4 i n { n
älä	{ l {
älımınän	{ l M m M n { n
älımızdän	{ l M m M z d { n
älımızä	{ l M m M z {
äm	{ m
ämda	{ m d a
ämdä	{ m d {
ämnısi	{ m n M s i
ämägi	{ m { J\ i
ämäk	{ m { k
ämäklär	{ m { k l { r
ämıläriinän	{ m M 5 { 4 i n { n
ämılärımdä	{ m M 5 { 4 M m d {
ämım	{ m M m
ämımdillär	{ m M m d i l: { r
ämısi	{ m M s i
ämısiinän	{ m M s i n { n
ändi	{ n d i
äp	{ p
äpsındän	{ p s M n d { n
äpsıni	{ p s M n i
äpsınä	{ p s M n {
äptä	{ p t {
äpımız	{ p M m M z
äpımızä	{ p M m M z {
äpımızäm	{ p M m M z { m
äpısi	{ p M s i
äpısindän	{ p M s i n d { n
är	{ r
ärbiriš	{ 4 b i 4 i S
ärbiriši	{ 4 b i 4 i S i
ärbiryana	{ 4 b i 4 j a n a
ärbirıš	{ 4 b i 4 M S
ärdama	{ 4 d a m a
ärdämä	{ 4 d { m {
äriš	{ 4 i S
äriši	{ 4 i S i
ärišta	{ 4 i S t a
ärištä	{ 4 i S t {
ärišımız	{ 4 i S M m M z
ärkärän	{ 4 c { 4 { n
ärkäš	{ 4 c { S
äroyun	{ 4 o j u n
ärvänidän	{ 4 v { n i d { n
ärvänli	{ 4 v { n l i
ärvänlia	{ 4 v { n l i a
ärvänlidän	{ 4 v { n l i d { n
ärvännidä	{ 4 v { n n i d {
ärvännidän	{ 4 v { n n i d { n
äryanda	{ 4 j a n d a
ärzurumdan	{ 4 z u 4 u m d a n
ärä	{ 4 {
ärägetti	{ 4 { J\ e t: i
ärägettım	{ 4 { J\ e t: M m
ärägiderlär	{ 4 { J\ i d e 4 l { r
ärım	{ 4 M m
ärımın	{ 4 M m M n
ärımınän	{ 4 M m M n { n
ärımızä	{ 4 M m M z {
ättır	{ t: M r
äv	{ v
ävdä	{ v d {
ävdämävdä	{ v d { m { v d {
ävdän	{ v d { n
ävi	{ v i
ävimizdä	{ v i m i z d {
ävldä	{ v l d {
ävlä	{ v l {
ävländi	{ v l { n d i
ävländä	{ v l { n d {
ävländı	{ v l { n d M
ävländıh	{ v l { n d M x
ävländıhtan	{ v l { n d M x t a n
ävländılär	{ v l { n d M 5 { r
ävländım	{ v l { n d M m
ävlänmaya	{ v l { n m a j a
ävlänmämiš	{ v l { n m { m i S
ävlänmäya	{ v l { n m { j a
ävlänırlär	{ v l { n M 4 l { r
ävlär	{ v l { r
ävlärdän	{ v l { 4 d { n
ävläri	{ v l { 4 i
ävlärımızdädä	{ v l { 4 M m M z d { d {
ävlärımızi	{ v l { 4 M m M z i
ävlärına	{ v l { 4 M n a
ävlärıni	{ v l { 4 M n i
ävmäv	{ v m { v
ävmävımız	{ v m { v M m M z
ävräldä	{ v 4 { l d {
ävränliidi	{ v 4 { n l i d i
ävä	{ v {
äväačenda	{ v { a tS e n d a
ävädä	{ v { d {
äväldän	{ v { l d { n
äväldändır	{ v { l d { n d M r
ävälki	{ v { l c i
ävänčılä	{ v { n tS M 5 {
ävın	{ v M n
ävınä	{ v M n {
äziz	{ z i z
öbür	9 b y r
öbüri	9 b y 4 i
öbüridä	9 b y 4 i d {
öbürlär	9 b y 4 l { r
öbürüni	9 b y 4 y n i
ögi	9 J\ i
öglärä	9 g l { 4 {
ögza	9 g z a
ögzä	9 g z {
ögündädır	9 J\ y n d { d M r
ökmät	9 k m { t
ökmättä	9 k m { t: {
ökmätım	9 k m { t M m
öküzi	9 c y z i
öldi	9 l d i
öldülär	9 l d y l { r
öldürirdılär	9 l d y 4 i 4 d M 5 { r
ölerdi	9 l e 4 d i
ölerdılär	9 l e 4 d M 5 { r
ölierdi	9 l i e 4 d i
ölmüšti	9 l m y S t i
ölmıš	9 l m M S
ölända	9 l { n d a
öländä	9 l { n d {
ölänktän	9 l { n k t { n
örgädirlär	9 4 J\ { d i 4 l { r
örgändi	9 4 J\ { n d i
örgändıh	9 4 J\ { n d M x
örgänirlär	9 4 J\ { n i 4 l { r
örgänmišım	9 4 J\ { n m i S M m
örgänälär	9 4 J\ { n { l { r
örgätti	9 4 J\ { t: i
örtüli	9 4 t y l i
ötirdi	9 t i 4 d i
öttüri	9 t: y 4 i
ötüri	9 t y 4 i
övlädän	9 v l { d { n
özgä	9 z J\ {
özgäsınä	9 z J\ { s M n {
özgätävır	9 z J\ { t { v M r
özgäyana	9 z J\ { j a n a
özgäyanda	9 z J\ { j a n d a
öčüri	9 tS y 4 i
öčüriidır	9 tS y 4 i d M r
ürägımız	y 4 { g M m M z
üsti	y s t i
üstümüzdän	y s t y m y z d { n
üstündä	y s t y n d {
üstünä	y s t y n {
üč	y tS
üči	y tS i
üčtänä	y tS t { n {
üčtänädä	y tS t { n { d {
čai	tS a i
čaimız	tS a i m M z
čalan	tS a 5 a n
čaler	tS a 5 e r
čalierlar	tS a 5 i e 4 l a r
čalierıh	tS a 5 i e 4 M x
čalil	tS a 5 i l
čalir	tS a 5 i r
čalirlar	tS a 5 i 4 l a r
čalıp	tS a 5 M p
čalıšerdıh	tS a 5 M S e 4 d M x
čalıšerlar	tS a 5 M S e 4 l a r
čalıširdıh	tS a 5 M S i 4 d M x
čalıširdılar	tS a 5 M S i 4 d M 5 a r
čalıšmah	tS a 5 M S m a x
čalıštıh	tS a 5 M S t M x
čam	tS a m
čamlar	tS a m l a r
čamlarınan	tS a m l a 4 M n a n
čapaevkada	tS a p a e v k a d a
čatınnıh	tS a t M n n M x
čay	tS a j
čağırajah	tS a G M 4 a dZ a x
čağırdılar	tS a G M 4 d M 5 a r
čağırer	tS a G M 4 e r
čağırerdılär	tS a G M 4 e 4 d M 5 { r
čağırerlär	tS a G M 4 e 4 l { r
čağırirlär	tS a G M 4 i 4 l { r
čağırirıh	tS a G M 4 i 4 M x
čağırmah	tS a G M 4 m a x
čağırırdi	tS a G M 4 M 4 d i
čağırırdılär	tS a G M 4 M 4 d M 5 { r
čem	tS e m
čiftlär	tS i f t l { r
čimierdıh	tS i m i e 4 d M x
čoban	tS o b a n
čobannığa	tS o b a n n M G a
čobannığınan	tS o b a n n M G M n a n
čoh	tS o x
čohtan	tS o x t a n
čojuh	tS o dZ u x
čoğ	tS o G
čoğaldılar	tS o G a 5 d M 5 a r
čoğda	tS o G d a
čoğdır	tS o G d M r
čoği	tS o G i
čoğiinän	tS o G i n { n
čoğudılar	tS o G u d M 5 a r
ču	tS u
čäkieram	tS { c i e 4 a m
čäkierıh	tS { c i e 4 M x
čäkmäh	tS { k m { x
čätin	tS { t i n
čätindır	tS { t i n d M r
čätın	tS { t M n
čätındır	tS { t M n d M r
čätınlıh	tS { t M n l M x
čätınnıh	tS { t M n n M x
čätınnıhtır	tS { t M n n M x t M r
čätınnıği	tS { t M n n M G i
čätınnığıdi	tS { t M n n M G M d i
čätınnığımız	tS { t M n n M G M m M z
čätınnığınän	tS { t M n n M G M n { n
čätınıdi	tS { t M n M d i
čätınıh	tS { t M n M x
čäğırirdi	tS { G M 4 i 4 d i
čöker	tS 9 c e r
čökärıh	tS 9 c { 4 M x
čöräk	tS 9 4 { k
čöräktän	tS 9 4 { k t { n
čüčügüdüm	tS y tS y J\ y d y m
čüčük	tS y tS y k
čıh	tS M x
čıhandan	tS M x a n d a n
čıheram	tS M x e 4 a m
čıherıh	tS M x e 4 M x
čıhierah	tS M x i e 4 a x
čıhierdım	tS M x i e 4 d M m
čıhierlär	tS M x i e 4 l { r
čıhierıh	tS M x i e 4 M x
čıhirlär	tS M x i 4 l { r
čıhirıh	tS M x i 4 M x
čıhmah	tS M x m a x
čıhmia	tS M x m i a
čıhti	tS M x t i
čıhtılar	tS M x t M 5 a r
čıhtım	tS M x t M m
čıhıp	tS M x M p
čılpah	tS M 5 p a x
čığardirım	tS M G a 4 d i 4 M m
čığırir	tS M G M 4 i r
čığırirıh	tS M G M 4 i 4 M x
ğabağında	G a b a G M n d a
ğabul	G a b u 5
ğabulolsun	G a b u 5 o 5 s u n
ğala	G a 5 a
ğalajahsıs	G a 5 a dZ a x s M s
ğalalar	G a 5 a 5 a r
ğalannar	G a 5 a n n a r
ğalar	G a 5 a r
ğaldi	G a 5 d i
ğaldıh	G a 5 d M x
ğaldılar	G a 5 d M 5 a r
ğaldım	G a 5 d M m
ğaldırir	G a 5 d M 4 i r
ğaler	G a 5 e r
ğalherlär	G a 5 x e 4 l { r
ğalhierıh	G a 5 x i e 4 M x
ğalhirdıh	G a 5 x i 4 d M x
ğalhirıh	G a 5 x i 4 M x
ğalhmıšımğalhali	G a 5 x m M S M m G a 5 x a 5 i
ğalhtım	G a 5 x t M m
ğalhtınhta	G a 5 x t M n x t a
ğalhıp	G a 5 x M p
ğalierdım	G a 5 i e 4 d M m
ğalir	G a 5 i r
ğalirdıh	G a 5 i 4 d M x
ğalirıh	G a 5 i 4 M x
ğalmamıš	G a 5 m a m M S
ğalmer	G a 5 m e r
ğalmerlär	G a 5 m e 4 l { r
ğalmirıh	G a 5 m i 4 M x
ğalmiš	G a 5 m i S
ğalmıš	G a 5 m M S
ğalmıšti	G a 5 m M S t i
ğalmıštır	G a 5 m M S t M r
ğalmıšıh	G a 5 m M S M x
ğanaahli	G a n a x l i
ğanahlidanda	G a n a x l i d a n d a
ğanahlii	G a n a x l i
ğanamas	G a n a m a s
ğanamerdıh	G a n a m e 4 d M x
ğanamierdıh	G a n a m i e 4 d M x
ğanamiirıh	G a n a m i 4 M x
ğandıramirıh	G a n d M 4 a m i 4 M x
ğanerdımda	G a n e 4 d M m d a
ğanir	G a n i r
ğanirdıh	G a n i 4 d M x
ğanirıh	G a n i 4 M x
ğanirım	G a n i 4 M m
ğanmas	G a n m a s
ğanmaya	G a n m a j a
ğanmerdım	G a n m e 4 d M m
ğanmirıh	G a n m i 4 M x
ğanılir	G a n M 5 i r
ğapi	G a p i
ğapiağalani	G a p i a G a 5 a n i
ğapibajasız	G a p i b a dZ a s M z
ğapın	G a p M n
ğapısına	G a p M s M n a
ğapısında	G a p M s M n d a
ğar	G a r
ğara	G a 4 a
ğaralti	G a 4 a 5 t i
ğarannıh	G a 4 a n n M x
ğarannığınan	G a 4 a n n M G M n a n
ğarağul	G a 4 a G u 5
ğardaš	G a 4 d a S
ğardaši	G a 4 d a S i
ğardašida	G a 4 d a S i d a
ğardašlari	G a 4 d a S l a 4 i
ğardašlarım	G a 4 d a S l a 4 M m
ğardašlarıma	G a 4 d a S l a 4 M m a
ğardašlarımda	G a 4 d a S l a 4 M m d a
ğardašlarımdä	G a 4 d a S l a 4 M m d {
ğardašların	G a 4 d a S l a 4 M n
ğardašıh	G a 4 d a S M x
ğardašım	G a 4 d a S M m
ğardašıma	G a 4 d a S M m a
ğardašımda	G a 4 d a S M m d a
ğari	G a 4 i
ğariinän	G a 4 i n { n
ğarsdan	G a 4 s d a n
ğarslisıs	G a 4 s l i s M s
ğarsta	G a 4 s t a
ğarıdan	G a 4 M d a n
ğarılar	G a 4 M 5 a r
ğarılarımız	G a 4 M 5 a 4 M m M z
ğarım	G a 4 M m
ğarımdan	G a 4 M m d a n
ğarısi	G a 4 M s i
ğarıšir	G a 4 M S i r
ğarıšmerlär	G a 4 M S m e 4 l { r
ğarıšmir	G a 4 M S m i r
ğat	G a t
ğaterdılär	G a t e 4 d M 5 { r
ğatierıh	G a t i e 4 M x
ğazanerdi	G a z a n e 4 d i
ğač	G a tS
ğačmıšti	G a tS m M S t i
ğačti	G a tS t i
ğačtıh	G a tS t M x
ğačırdılar	G a tS M 4 d M 5 a r
ğačırmah	G a tS M 4 m a x
ğašti	G a S t i
ğašyoh	G a S j o x
ğoidular	G o i d u 5 a r
ğoierlär	G o i e 4 l { r
ğoierıh	G o i e 4 M x
ğoirdi	G o i 4 d i
ğoja	G o dZ a
ğojalarında	G o dZ a 5 a 4 M n d a
ğojaldıh	G o dZ a 5 d M x
ğojaldılar	G o dZ a 5 d M 5 a r
ğolailandi	G o 5 a i l a n d i
ğoluma	G o 5 u m a
ğonuširih	G o n u S i 4 i x
ğonuširıh	G o n u S i 4 M x
ğonšia	G o n S i a
ğonšularımız	G o n S u 5 a 4 M m M z
ğonšuluh	G o n S u 5 u x
ğorğorudi	G o 4 G o 4 u d i
ğoyun	G o j u n
ğoyuna	G o j u n a
ğoyuni	G o j u n i
ğoyunnar	G o j u n n a r
ğoyunumuz	G o j u n u m u z
ğoyurierıh	G o j u 4 i e 4 M x
ğoyurmierdılär	G o j u 4 m i e 4 d M 5 { r
ğoččağ	G o tS tS a G
ğurban	G u 4 b a n
ğurbana	G u 4 b a n a
ğurbanada	G u 4 b a n a d a
ğurbanda	G u 4 b a n d a
ğurbani	G u 4 b a n i
ğurbanlar	G u 4 b a n l a r
ğurbannar	G u 4 b a n n a r
ğurbannari	G u 4 b a n n a 4 i
ğurbannarımızi	G u 4 b a n n a 4 M m M z i
ğurbannarımızida	G u 4 b a n n a 4 M m M z i d a
ğurbannarıni	G u 4 b a n n a 4 M n i
ğurbannıh	G u 4 b a n n M x
ğurbanom	G u 4 b a n o m
ğurbansa	G u 4 b a n s a
ğurbanımızi	G u 4 b a n M m M z i
ğurjülär	G u 4 dZ y l { r
ğurtaldum	G u 4 t a 5 d u m
ğurtaldıh	G u 4 t a 5 d M x
ğurtuldi	G u 4 t u 5 d i
ğurtulduh	G u 4 t u 5 d u x
ğurtuldular	G u 4 t u 5 d u 5 a r
ğurtuldum	G u 4 t u 5 d u m
ğurtulier	G u 4 t u 5 i e r
ğurtulmadi	G u 4 t u 5 m a d i
ğurtulmuštum	G u 4 t u 5 m u S t u m
ğurtulmıšıh	G u 4 t u 5 m M S M x
ğurturirıh	G u 4 t u 4 i 4 M x
ğurudierıh	G u 4 u d i e 4 M x
ğurulier	G u 4 u 5 i e r
ğutuldum	G u t u 5 d u m
ğuvaladılar	G u v a 5 a d M 5 a r
ğuzäl	G u z { l
ğüjüdan	G y dZ y d a n
ğıpğırmızi	G M p G M 4 m M z i
ğırahtan	G M 4 a x t a n
ğırh	G M 4 x
ğırhbeš	G M 4 x b e S
ğırirdılar	G M 4 i 4 d M 5 a r
ğırıhsırıği	G M 4 M x s M 4 M G i
ğız	G M z
ğızi	G M z i
ğızlar	G M z l a r
ğızıdım	G M z M d M m
ğızılyumurta	G M z M 5 j u m u 4 t a
ğızılyumurtada	G M z M 5 j u m u 4 t a d a
ğızım	G M z M m
ğıčüstünä	G M tS y s t y n {
ğıš	G M S
ğıšlarımi	G M S l a 4 M m i
ınan	M n a n
šami	S a m i
šei	S e i
šeida	S e i d a
šeidir	S e i d i r
šeidä	S e i d {
šeidädirlär	S e i d { d i 4 l { r
šeidäh	S e i d { x
šeidän	S e i d { n
šeidır	S e i d M r
šeiidi	S e i d i
šeilär	S e i l { r
šeiläri	S e i l { 4 i
šeilärä	S e i l { 4 {
šeimız	S e i m M z
šeinanda	S e i n a n d a
šeini	S e i n i
šeinika	S e i n i k a
šeinän	S e i n { n
šendigınän	S e n d i g M n { n
šeya	S e j a
šeyandan	S e j a n d a n
šeä	S e {
šidiačen	S i d i a tS e n
šindi	S i n d i
šindiačahta	S i n d i a tS a x t a
šindiačanda	S i n d i a tS a n d a
šindiačatta	S i n d i a tS a t: a
šindiačağta	S i n d i a tS a G t a
šindida	S i n d i d a
šindidä	S i n d i d {
šindik	S i n d i k
šindiki	S i n d i c i
šindiktä	S i n d i k t {
šindikä	S i n d i c {
školada	S k o 5 a d a
školadada	S k o 5 a d a d a
školai	S k o 5 a i
školalara	S k o 5 a 5 a 4 a
školamız	S k o 5 a m M z
školamızi	S k o 5 a m M z i
školanın	S k o 5 a n M n
školasi	S k o 5 a s i
školasına	S k o 5 a s M n a
školaya	S k o 5 a j a
šura	S u 4 a
šäärdä	S { 4 d {
šäärlärdän	S { 4 l { 4 d { n
šäärmäärä	S { r m { 4 {
šäärä	S { 4 {
šäärın	S { 4 M n
šükür	S y c y r
